abandon	abandon: abandonar
ability	ability: subs. habilidade
able	able: adj.sint. capaz, able: adj.sint. capaz
abort	abort: abortar
abortion	abortion: subs. aborto
about	about: pr. a respeito de, about: pr. sobre, about: adv. aproximadamente
above	above: pr. acima de, above: adv. acima, above: adv. arriba, above: adv. no alto, above: adv. em cima
above all	above all: adv. sobretudo
absence	absence: subs. ausência
absent	absent: adj. ausente
absenteeism	absenteeism: subs. absentismo
absolute	absolute: adj. absoluto
absolutely	absolutely: adv. absolutamente
absorb	absorb: absorver
abstention	abstention: subs. abstenção
abstraction	abstraction: subs. abstracção, abstraction: subs. abstração
absurd	absurd: adj. absurdo
abundance	abundance: subs. abundância, abundance: subs. fartura
abundant	abundant: adj. abundante
abuse	abuse: subs. abuso, abuse: insultar, abuse: maltratar
abyss	abyss: subs. abismo
academic	academic: adj. académico, academic: adj. acadêmico
acceleration	acceleration: subs. aceleração
accent	accent: subs. sotaque, accent: subs. acento
acceptable	acceptable: adj. aceitável
accept	accept: aceitar
acceptance	acceptance: subs. aceitação
access	access: subs. acesso, access: aceder
accident	accident: subs. acidente
accidentally	accidentally: adv. acidentalmente
accommodate	accommodate: acomodar
accommodation	accommodation: subs. alojamento
accompanier	accompanier: subs. acompanhante
accompany	accompany: acompanhar
accomplish	accomplish: cumprir
accord	accord: subs. acordo
according	according: pr. segundo
according to	according to: pr. segundo
account	account: subs. conta, account: subs. contagem, account: subs. relação
accountancy	accountancy: subs. contabilidade
accounting	accounting: subs. contabilidade
accumulate	accumulate: acumular
accuracy	accuracy: subs. precisão
accuse	accuse: acusar
accustom	accustom: costumar
achieve	achieve: alcançar, achieve: atingir, achieve: conseguir
acknowledge	acknowledge: reconhecer
acquire	acquire: adquirir
acquisition	acquisition: subs. aquisição
act	act: subs. acto, act: subs. ato, act: subs. auto, act: subs. lei, act: actuar, act: agir
action	action: subs. acção, action: subs. ação
active	active: adj. activo, active: adj. ativo
actively	actively: adv. activamente, actively: adv. ativamente
activity	activity: subs. actividade, activity: subs. atividade
actor	actor: subs. actor, actor: subs. ator
actual	actual: adj. real
actuality	actuality: subs. actualidade, actuality: subs. atualidade
actually	actually: adv. de fato
actuate	actuate: activar, actuate: ativar
acute	acute: adj. agudo
acutely	acutely: adv. profundamente
ad	ad: subs. anúncio
adapt	adapt: adaptar
adaptation	adaptation: subs. adaptação
add	add: somar, add: acrescentar
addict	addict: subs. adicto
additional	additional: adj. adicional
additionally	additionally: adv. ademais
address	address: subs. direcção, address: subs. direção, address: subs. endereço, address: dirigir
adduce	adduce: alegar
adequately	adequately: adv. adequadamente
adhesion	adhesion: subs. adesão
adjacent	adjacent: adj. adjacente
adjective	adjective: subs. adjectivo, adjective: subs. adjetivo
adjust	adjust: ajustar
administer	administer: administrar
administration	administration: subs. administração
administrative	administrative: adj. administrativo
administrator	administrator: subs. administrador
admiration	admiration: subs. admiração
admire	admire: admirar
admit	admit: admitir
adopt	adopt: adoptar, adopt: adotar
adoption	adoption: subs. adopção, adoption: subs. adoção
adoptive	adoptive: adj. adoptivo, adoptive: adj. adotivo
adult	adult: subs. adulto
adultery	adultery: subs. adultério
advance	advance: subs. progresso, advance: adiantar
advancement	advancement: subs. progresso
advantage	advantage: subs. vantagem
adventure	adventure: subs. aventura
advert	advert: subs. publicidade
advertise	advertise: anunciar
advertisement	advertisement: subs. anúncio
advertising	advertising: subs. publicidade
advice	advice: subs. conselho
advisable	advisable: adj. aconselhável
advise	advise: aconselhar
advisory	advisory: adj. aconselhável
advocate	advocate: defender
aeolian	aeolian: adj. eólico
aerial	aerial: adj. aéreo
aesthetic	aesthetic: adj. estético
affair	affair: subs. assunto
affect	affect: afectar, affect: afetar
affirm	affirm: afirmar
affirmation	affirmation: subs. afirmação
afford	afford: proporcionar
african	African: adj. africano
after	after: pr. depois de, after: pr. trás, after: adv. depois
afternoon	afternoon: subs. tarde
after this manner	after this manner: adv. desta guisa
afterwards	afterwards: adv. depois
again	again: adv. novamente
against	against: pr. contra, against: adv. na contramão
age	age: subs. idade, age: envelhecer
agency	agency: subs. agência
agent	agent: subs. agente
aggravate	aggravate: agravar
aggressive	aggressive: adj. agressivo
agitate	agitate: agitar
agrarian	agrarian: adj. agrário
agree	agree: concordar, agree: lembrar
agreement	agreement: subs. acordo, agreement: subs. contrato
agricultural	agricultural: adj. agrícola
agriculturalist	agriculturalist: subs. agricultor
agriculture	agriculture: subs. agricultura
ahead	ahead: adv. adiante
aid	aid: subs. ajuda
aim	aim: subs. objectivo, aim: subs. objetivo, aim: apontar, aim: assomar, aim: dirigir
air	air: subs. ar
aircraft	aircraft: subs. avião
airplane	airplane: subs. avião
airport	airport: subs. aeroporto
akin	akin: adj. semelhante
alarm	alarm: subs. alarme
album	album: subs. álbum
alcohol	alcohol: subs. álcool
alien	alien: subs. estrangeiro
alike	alike: adj. semelhante, alike: adv. igualmente
alimentary	alimentary: adj. alimentário, alimentary: adj. alimentar
alive	alive: adj. vivo
all	all: predet.sp. todo, all: predet. todo, all: prn.tn.mf.sp. tudo
allegation	allegation: subs. alegação
allege	allege: alegar
allegedly	allegedly: adv. supostamente
all of a sudden	all of a sudden: adv. de repente
all over	all over: adv. por todos os lados
allow	allow: admitir, allow: deixar, allow: permitir
allowance	allowance: subs. pensão
all right	all right: adv. bem
all the more	all the more: adv. bem mais
all the way	all the way: adv. completamente
all the while	all the while: adv. o tempo todo
allusion	allusion: subs. alusão
ally	ally: subs. aliado
alms	alms: n.pl. esmola
aloft	aloft: adv. acima
alone	alone: adj. sozinho
a lot	a lot: adv. muito
alpine	alpine: adj. alpino
already	already: adv. já
alright	alright: adv. bem
also	also: adv. também
altar	altar: subs. altar
alter	alter: alterar
alteration	alteration: subs. alteração
alternative	alternative: adj. alternativo
although	although: cnjadv. ainda que, although: cnjadv. embora, although: cnjadv. mesmo que, although: cnjadv. nen que, although: cnjadv. posto que, although: cnjadv. se bem que, although: cnjadv. apesar que
altitude	altitude: subs. altitude, altitude: subs. altura
altogether	altogether: adv. ao todo
always	always: adv. sempre
amateur	amateur: subs. aficionado
ambassador	ambassador: subs. embaixador
ambition	ambition: subs. ambição
ambitious	ambitious: adj. ambicioso
amendment	amendment: subs. emenda
american	American: subs. americano, American: adj. americano
amid	amid: pr. entre
among	among: pr. entre, among: pr. por entre
amongst	amongst: pr. entre
amount	amount: subs. quantidade
amplitude	amplitude: subs. amplitude
amuse	amuse: divertir
analyse	analyse: analisar
analysis	analysis: subs. análise, analysis: subs. análise, analysis: subs. análise
analyze	analyze: analisar
anarchist	anarchist: subs. anarquista
ancestor	ancestor: subs. antepassado
ancient	ancient: adj. antigo
and	and: cnjcoo. e
anecdote	anecdote: subs. episódio
angel	angel: subs. anjo
anger	anger: subs. raiva, anger: subs. ira
angle	angle: subs. ângulo
animal	animal: subs. animal
animation	animation: subs. animação
ankle	ankle: subs. tornozelo
anniversary	anniversary: subs. aniversário
announce	announce: anunciar
announcement	announcement: subs. anúncio, announcement: subs. convocação
annoying	annoying: adj. chateado, annoying: adj. molesto
annual	annual: adj. anual
annually	annually: adv. anualmente
anonymity	anonymity: subs. anonimato
anonymous	anonymous: adj. anónimo, anonymous: adj. anônimo
another	another: det.ind. outro, another: det.ind.sg. outro, another: det.ind.sg. outro, another: prn.tn.m.sg. outro
another one	another one: prn.tn.m.sg. outro
answer	answer: contestar, answer: responder
antique	antique: adj. antigo
anus	anus: subs. ânus, anus: n.ND. ânus
anxiety	anxiety: subs. ânsia, anxiety: subs. ansiedade, anxiety: subs. angústia, anxiety: subs. nervosismo
anxious	anxious: adj. ansioso
any	any: det. algum, any: det.ind. nenhum, any: det.ind. nenhum, any: det.ind.sp. qualquer, any: preadv. muito, any: prn.tn.mf.sp. algum, any: prn.tn.mf.sp. nenhum, any: prn.tn.mf.sp. nenhum, any: prn.tn.mf.sp. nenhum, any: prn.tn.mf.sp. nenhum, any: prn.tn.mf.sp. qualquer
anybody	anybody: prn.tn.m.sg. alguém, anybody: prn.tn.m.sg. ninguém, anybody: prn.tn.m.sg. qualquer
any more	any more: adv. mais
anyone	anyone: prn.tn.m.sg. alguém, anyone: prn.tn.m.sg. ninguém, anyone: prn.tn.m.sg. qualquer, anyone: prn.tn.m.sg. quem quer
any one	any one: prn.tn.m.sg. qualquer, any one: prn.tn.m.sg. quem quer
anything	anything: prn.tn.m. algo, anything: prn.tn.m. nada
apart	apart: adv. aparte
apartment	apartment: subs. apartamento
apparent	apparent: adj. aparente
apparently	apparently: adv. aparentemente
appeal	appeal: subs. atractivo, appeal: subs. atrativo, appeal: subs. apelação, appeal: subs. solicitação, appeal: apelar
appearance	appearance: subs. aspecto, appearance: subs. aparência
appear	appear: aparecer, appear: parecer
applaud	applaud: aplaudir
applause	applause: subs. aplauso
apple	apple: subs. maçã, apple: subs. quadra
appliance	appliance: subs. electrodoméstico, appliance: subs. eletrodoméstico
applicant	applicant: subs. solicitante
application	application: subs. aplicação, application: subs. solicitação, application: subs. solicitude
apply	apply: aplicar
apply for	apply for: solicitar
appoint	appoint: nomear
appraise	appraise: valorizar, appraise: ponderar
appreciate	appreciate: apreciar
approach	approach: subs. aproximação, approach: subs. enfoque
approval	approval: subs. aprovação
approve	approve: aprovar
approximate	approximate: aproximar
approximately	approximately: adv. aproximadamente
approximation	approximation: subs. aproximação
april	April: subs. abril
a priori	a priori: adv. a priori
apt	apt: adj.sint. apto, apt: adj.sint. apto, apt: adj.sint. apto, apt: adj.sint. apto, apt: adj.sint. apto, apt: adj.sint. apto
arab	Arab: adj. árabe
archaeologic	archaeologic: adj. arqueológico
arch	arch: subs. arco
archbishop	archbishop: subs. arcebispo
architect	architect: n.sg. arquitecto, architect: n.sg. arquitecto, architect: n.sg. arquitecto, architect: n.sg. arquitecto, architect: n.sg. arquitecto, architect: n.sg. arquiteto, architect: n.sg. arquiteto, architect: n.sg. arquiteto, architect: n.sg. arquiteto, architect: n.pl. arquitecto, architect: n.pl. arquitecto, architect: n.pl. arquitecto, architect: n.pl. arquitecto, architect: n.pl. arquitecto, architect: n.pl. arquiteto, architect: n.pl. arquiteto, architect: n.pl. arquiteto, architect: n.pl. arquiteto
architecture	architecture: subs. arquitectura
archive	archive: subs. arquivo
area	area: subs. área
argentine	Argentine: adj. argentino
argue	argue: argumentar, argue: discutir
argument	argument: subs. argumento, argument: subs. discussão
arise	arise: surgir
armament	armament: subs. armamento
arm	arm: n.pl. arma, arm: n.sg. braço, arm: n.pl. braço, arm: armar
armchair	armchair: subs. cadeirão
armour	armour: blindar, armour: subs. armadura
army	army: subs. exército
aroma	aroma: subs. aroma
around	around: adv. ao redor, around: adv. arredor, around: adv. em redor, around: adv. por volta, around: adv. ao arredor
arouse	arouse: acordar
arrangement	arrangement: subs. acordo, arrangement: subs. arranjo
arrest	arrest: subs. detenção, arrest: subs. detenção, arrest: prender
arrival	arrival: subs. chegada
arrive	arrive: chegar
arrow	arrow: subs. flecha, arrow: subs. seta
arsenal	arsenal: subs. arsenal
art	art: subs. arte
article	article: subs. artigo
articulate	articulate: articular
artifact	artifact: subs. artefacto, artifact: subs. artefato
artificial	artificial: adj. artificial
artisan	artisan: subs. artesão
artist	artist: subs. artista
artistic	artistic: adj. artístico
as a	as a: pr. como, as a: pr. a guisa de
as a consequence of	as a consequence of: pr. em consequência de
as a matter of fact	as a matter of fact: adv. de fato
as	as: cnjadv. enquanto, as: cnjadv. segundo, as: preadv. tão, as: pr. como
ascertain	ascertain: constatar
asian	Asian: subs. asiático, Asian: adj. asiático
ask	ask: pedir, ask: perguntar
ask for	ask for: pedir
aspect	aspect: subs. aspecto
as regards	as regards: pr. com respeito a
ass	ass: subs. asno
assault	assault: subs. agressão
assemble	assemble: reunir
assembly	assembly: subs. assembleia, assembly: subs. assembléia
assess	assess: avaliar
assessment	assessment: subs. valoração
asset	asset: subs. vantagem
assign	assign: atribuir
assistance	assistance: subs. assistência
assistant	assistant: subs. assistente
assist	assist: assistir
association	association: subs. associação
assume	assume: assumir, assume: supor
assumption	assumption: subs. suposição
astronaut	astronaut: subs. astronauta
astronomer	astronomer: subs. astrónomo, astronomer: subs. astrônomo
as well	as well: adv. também
asylum	asylum: subs. asilo
at all	at all: adv. nada
at a time	at a time: adv. ao mesmo tempo
at	at: pr. a, at: pr. em
athlete	athlete: subs. atleta
athletics	athletics: subs. atletismo
at least	at least: adv. no mínimo, at least: adv. sequer
at most	at most: adv. no máximo
atomic	atomic: adj. atómico, atomic: adj. atômico
at once	at once: adv. imediatamente
at present	at present: adv. actualmente, at present: adv. atualmente
attach	attach: sujeitar
attack	attack: subs. atentado, attack: subs. ataque, attack: atacar, attack: atentar
attacker	attacker: subs. atacante
attain	attain: conseguir
attainment	attainment: subs. lucro
attempt	attempt: subs. atentado, attempt: subs. tentativa, attempt: tentar
attendant	attendant: subs. encarregado
attend	attend: atender
attention	attention: subs. atendimento, attention: subs. atenção
attentive	attentive: adj. atento
attentively	attentively: adv. atenciosamente, attentively: adv. atentamente
at the double	at the double: adv. rapidamente
at the latest	at the latest: adv. no mais tardar
at the maximum	at the maximum: adv. no máximo
at the most	at the most: adv. no máximo
at the point	at the point: adv. no ponto
at the same time	at the same time: adv. ao mesmo tempo
at the very most	at the very most: adv. no máximo
attic	attic: subs. cobertura
attitude	attitude: subs. atitude
attorney	attorney: subs. advogado
attract	attract: atrair
attraction	attraction: subs. atração
attractive	attractive: adj. atractivo, attractive: adj. atraente
attribute	attribute: atribuir
auction	auction: subs. leilão
audacious	audacious: adj. audaz, audacious: adj. audaz
audible	audible: adj. sonoro
audience	audience: subs. audiência
audiovisual	audiovisual: adj. audiovisual
auditorium	auditorium: subs. auditório
august	August: subs. agosto
australian	Australian: adj. australiano
austrian	Austrian: adj. austríaco
authentic	authentic: adj. autêntico
author	author: subs. autor
authority	authority: subs. autoridade, authority: subs. chefia
authorize	authorize: autorizar
auto	auto: subs. carro
automatically	automatically: adv. automaticamente
automatic	automatic: adj. automático
autonomic	autonomic: adj. autonómico, autonomic: adj. autonômico
autonomous	autonomous: adj. autónomo, autonomous: adj. autônomo
autopsy	autopsy: subs. autópsia
autumn	autumn: subs. outono
available	available: adj. disponível
avenge	avenge: vingar
avenue	avenue: subs. avenida
average	average: subs. meia, average: subs. média, average: adj. médio
aversion	aversion: subs. aborrecimento, aversion: subs. aversão
aviation	aviation: subs. aviação
avoid	avoid: evitar
await	await: esperar
awaken	awaken: acordar, awaken: despertar
award	award: subs. prémio, award: outorgar
away	away: adv. fora
awful	awful: adj. terrível
awfully	awfully: adv. muito
axe	axe: subs. machado
axis	axis: subs. eixo
baby	baby: subs. criatura
back	back: subs. costas, back: adj. posterior, back: recuar, back: adv. atrás
background	background: subs. fundo, background: subs. fundo, background: subs. fundo
backwards	backwards: adv. atrás
bacterium	bacterium: subs. bactéria
bad	bad: adj.sint. mau, bad: adj.sint.comp. pior, bad: adj.sint.sup. pior
badly	badly: adv. mal
baffle	baffle: desconcertar
bag	bag: subs. bolsa
baggage	baggage: subs. bagagem
balance	balance: subs. equilíbrio, balance: subs. saldo, balance: subs. balanço, balance: equilibrar
balearic	Balearic: adj. balear
ball	ball: subs. pelota
balloon	balloon: subs. bola
ban	ban: subs. proibição, ban: proibir
band	band: subs. banda
bank	bank: subs. banco, bank: subs. orla
banker	banker: subs. banqueiro
banner	banner: subs. cartaz
banquet	banquet: subs. banquete
baptize	baptize: baptizar, baptize: batizar
bar	bar: subs. bar, bar: subs. barra
bargain	bargain: subs. negócio
barracks	barracks: subs. quartel
barren	barren: adj.sint. estéril
barrier	barrier: subs. barreira
baseball	baseball: subs. basebol, baseball: subs. beisebol
base	base: subs. base, base: basear
basically	basically: adv. basicamente
basic	basic: adj. básico
basilica	basilica: subs. basílica
basis	basis: subs. base
basketball	basketball: subs. basquete, basketball: subs. basquetebol
basket	basket: subs. cesta
batallion	batallion: subs. batalhão
battle	battle: subs. batalha
bay	bay: subs. baía
beach	beach: subs. praia
beak	beak: subs. bico
bear	bear: aguentar, bear: agüentar
beard	beard: subs. barba
beat	beat: bater
beautiful	beautiful: adj. bonito, beautiful: adj. belo, beautiful: adj. formoso
beauty	beauty: subs. beleza
be	be: vbser. ser
be born	be born: nascer
because	because: cnjadv. porque
because of	because of: pr. devido a, because of: pr. por causa de
become	become: acontecer, become: devir
bed	bed: subs. cama
bedroom	bedroom: subs. dormitório
beer	beer: subs. cerveja
before	before: pr. ante, before: adv. antes, before: adv. dantes
before everything	before everything: adv. antes de mais nada
before everything else	before everything else: adv. antes de mais nada
begin	begin: começar
beginning	beginning: subs. começo
behaviour	behaviour: subs. comportamento, behaviour: subs. conduta
behind	behind: pr. por trás de, behind: adv. detrás
being	being: subs. ser
be left	be left: ficar
belief	belief: subs. crença
believe	believe: acreditar, believe: crer
bell	bell: subs. sino
belong	belong: pertencer
belonging	belonging: subs. pertence
belt	belt: subs. cinto
be missing	be missing: faltar
bend	bend: subs. curva, bend: dobrar
benefit	benefit: subs. benefício, benefit: subs. prestação, benefit: beneficiar
benzine	benzine: subs. gasolina
bequeath	bequeath: legar
besides	besides: adv. ademais, besides: adv. além
best	best: adv. mais
bet	bet: apostar
betrayal	betrayal: subs. traição
betray	betray: atraiçoar
between	between: pr. entre, between: pr. por entre
be worth	be worth: valer
beyond	beyond: adv. para além
biblical	biblical: adj. bíblico
bid	bid: subs. tentativa, bid: subs. oferta
big	big: adj.sint. grande
bilateral	bilateral: adj. bilateral
bill	bill: subs. factura, bill: subs. fatura
bin	bin: subs. cubo
bind	bind: atar, bind: obrigar
binding	binding: adj. obrigatório
biological	biological: adj. biológico
bird	bird: subs. pássaro
birth	birth: subs. nascimento
birthday	birthday: subs. aniversário, birthday: subs. aniversário
bishop	bishop: subs. bispo
bite	bite: morder
bitter	bitter: adj. amargo
bitterness	bitterness: subs. amargura
bizarre	bizarre: adj. estranho
black	black: n.sg. negro, black: n.sg. negro, black: n.sg. negro, black: n.sg. negro, black: n.sg. negro, black: n.pl. negro, black: n.pl. negro, black: n.pl. negro, black: n.pl. negro, black: n.pl. negro, black: adj. negro, black: adj. negro, black: adj. negro, black: adj. negro, black: adj. negro, black: adj. negro, black: adj. preto, black: adj. preto, black: adj. preto, black: adj. preto, black: adj. preto
blade	blade: subs. folha
blame	blame: subs. culpa, blame: culpar
blank	blank: subs. espaço
blatantly	blatantly: adv. descaradamente
bleat	bleat: balir
bless	bless: abençoar
blessing	blessing: subs. bênção
blind	blind: adj.sint. cego
blindness	blindness: subs. cegueira
block	block: subs. bloco
blood	blood: subs. sangue
blow	blow: subs. golpe, blow: soprar
blue	blue: adj. azul
board	board: subs. tabuleiro, board: subs. junta
boat	boat: subs. barca
body	body: subs. corpo
bodyguard	bodyguard: subs. guarda-costas
bolivian	Bolivian: adj. boliviano
bombardment	bombardment: subs. bombardeio
bomb	bomb: subs. bomba, bomb: bombardear
bond	bond: subs. vínculo
bone	bone: subs. osso
bonfire	bonfire: subs. fogueira
book	book: subs. livro, book: reservar
bookshop	bookshop: subs. livraria
boost	boost: subs. impulso, boost: aumentar, boost: estimular
booty	booty: subs. botim
border	border: subs. fronteira
boss	boss: subs. cabeça, boss: subs. chefe, boss: subs. chefe, boss: subs. chefe, boss: subs. cabo
both	both: prn.tn.mf. ambos, both: prn.tn.mf. ambos os
bother	bother: molestar
bottle	bottle: subs. garrafa
bottom	bottom: subs. fundo, bottom: n.ND. fundo, bottom: n.ND. fundo, bottom: adj. inferior
boundary	boundary: subs. fronteira
boundless	boundless: adj. ilimitado
bouquet	bouquet: subs. ramo
bowl	bowl: subs. bola
box	box: subs. caixa
boxing	boxing: subs. boxe
boy	boy: subs. criança, boy: subs. menino, boy: subs. garoto, boy: subs. moço, boy: subs. rapariga, boy: subs. rapaz
boycott	boycott: subs. boicote
brain	brain: subs. cérebro
brake	brake: frear
branch	branch: subs. ramo, branch: subs. sucursal
brand	brand: subs. marca
brave	brave: adj.sint. valente
brazilian	Brazilian: adj. brasileiro
breach	breach: subs. ruptura
bread	bread: subs. pão
break	break: subs. rompimento, break: avariar, break: quebrar, break: romper
breakfast	breakfast: subs. almoço
breast	breast: subs. peito
breath	breath: subs. respiração
breathe	breathe: respirar
breathing	breathing: subs. respiração
breed	breed: criar
breezily	breezily: adv. alegremente
brick	brick: subs. tijolo
bricklayer	bricklayer: subs. pedreiro
bridegroom	bridegroom: subs. namorado, bridegroom: subs. noivo
bridge	bridge: subs. ponte
brief	brief: adj. breve, brief: informar
bright	bright: adj.sint. brilhante
brilliant	brilliant: adj. brilhante
bring	bring: portar, bring: trazer, bring: levar
bring together	bring together: sep. reunir
british	British: subs. britânico, British: adj. britânico
broad	broad: adj.sint. largo, broad: adj.sint. largo, broad: adj.sint. largo, broad: adj.sint. largo
broadcast	broadcast: subs. emissão
broaden	broaden: ampliar
brook	brook: subs. ribeiro
brother	brother: subs. irmão
brutal	brutal: adj. brutal
brutally	brutally: adv. brutalmente
bubble	bubble: subs. borbulha
bucket	bucket: subs. cubo
budgetary	budgetary: adj. orçamental, budgetary: adj. orçamentário
budget	budget: subs. orçamento, budget: subs. verba
build	build: construir
builder	builder: subs. construtor
building	building: subs. construção, building: subs. edifício, building: subs. prédio, building: subs. nave
bullet	bullet: subs. bala
bump	bump: chocar
bunch	bunch: subs. punhado, bunch: subs. ramo
bunk	bunk: subs. liteira
burden	burden: subs. ónus
bureau	bureau: subs. agência
burn	burn: subs. queimadura, burn: arder, burn: queimar
burning	burning: adj. ardente
burst	burst: subs. explosão
bury	bury: enterrar, bury: soterrar
bus	bus: subs. ónibus, bus: subs. ônibus
business	business: subs. negócio, business: adj. empresarial
but	but: cnjcoo. contudo, but: cnjcoo. mas, but: cnjcoo. senão, but: pr. excepto
but rather	but rather: cnjcoo. senão
button	button: subs. botão
buy	buy: comprar
buyer	buyer: subs. comprador
by a hair's breadth	by a hair's breadth: adv. por um fio, by a hair's breadth: adv. por um triz
by and by	by and by: adv. mais tarde
by	by: pr. por, by: pr. cerca de
by chance	by chance: adv. por acaso
by means of	by means of: pr. mediante
by the skin of her teeth	by the skin of her teeth: adv. por um fio
by the skin of his teeth	by the skin of his teeth: adv. por um fio
by the skin of its teeth	by the skin of its teeth: adv. por um fio
by the skin of my teeth	by the skin of my teeth: adv. por um fio
by the skin of one's teeth	by the skin of one's teeth: adv. por um fio
by the skin of our teeth	by the skin of our teeth: adv. por um fio
by the skin of their teeth	by the skin of their teeth: adv. por um fio
by the skin of your teeth	by the skin of your teeth: adv. por um fio
cabinet	cabinet: subs. gabinete
cable	cable: subs. cabo
calculate	calculate: calcular
calculation	calculation: subs. cálculo
calendar	calendar: subs. calendário
call	call: subs. apelo, call: denominar, call: chamar, call: gritar
call for	call for: pedir
calm	calm: adj.sint. calmo, calm: adj.sint. tranquilo, calm: acalmar
camera	camera: subs. câmara, camera: subs. câmera
campaign	campaign: subs. campanha
camp	camp: subs. acampamento, camp: subs. campo, camp: acampar
campus	campus: subs. campus, campus: n.ND. campus, campus: n.ND. câmpus
canadian	Canadian: subs. canadense, Canadian: adj. canadense
cancel	cancel: cancelar
cancer	cancer: subs. cancro, cancer: subs. câncer
candidate	candidate: subs. candidato
candidature	candidature: subs. candidatura
candle	candle: subs. vela
cane	cane: subs. cana
canvas	canvas: subs. tela
capability	capability: subs. capacidade
capable	capable: adj. capaz, capable: adj. capaz
capacity	capacity: subs. capacidade
cap	cap: subs. tampa
cape	cape: subs. cabeça, cape: subs. chefe, cape: subs. chefe, cape: subs. chefe, cape: subs. cabo
capital	capital: subs. capital, capital: subs. capital
capitalism	capitalism: subs. capitalismo
capsize	capsize: mudar
captain	captain: subs. capitão
captivity	captivity: subs. cativeiro
capture	capture: capturar
caravan	caravan: subs. caravana
carbon	carbon: subs. carbono
car	car: subs. automóvel, car: subs. carro
card	card: subs. carta, card: subs. cartão
cardiac	cardiac: adj. cardíaco
cardinal	cardinal: subs. cardeal
care	care: subs. cuidado, care: subs. cura
career	career: subs. carreira, career: subs. corrida
careful	careful: adj. prudente
carpet	carpet: subs. tapete
carriage	carriage: subs. transporte
carry	carry: portar, carry: trazer, carry: levar
case	case: subs. caso, case: subs. mala
cast	cast: subs. compartilhamento, cast: subs. partilha, cast: lançar, cast: fundir
castle	castle: subs. castelo
casual	casual: adj. casual
catalan	Catalan: subs. catalão, Catalan: adj. catalão
catalogue	catalogue: subs. catálogo
cataract	cataract: subs. catarata
catastrophe	catastrophe: subs. catástrofe
cat	cat: subs. gato
catch	catch: pegar
categorically	categorically: adv. rotundamente
cathedral	cathedral: subs. catedral
catheter	catheter: subs. sonda
catholic	Catholic: adj. católico
cause	cause: subs. causa, cause: causar, cause: provocar
cave	cave: subs. gruta, cave: subs. oca
ceiling	ceiling: subs. teto
celebrate	celebrate: celebrar
celebration	celebration: subs. celebração
cell	cell: subs. cela, cell: subs. célula
cemetery	cemetery: subs. cemitério
censorship	censorship: subs. censura
center	center: centrar
centimetre	centimetre: subs. centímetro
central	central: adj. central
centre	centre: subs. centro, centre: adj. central, centre: centrar
centrical	centrical: adj. central
century	century: subs. século
cereal	cereal: subs. cereal
cerebral	cerebral: adj. cerebral
ceremony	ceremony: subs. cerimónia, ceremony: subs. cerimônia
certain	certain: adj. seguro
certainty	certainty: subs. certeza
certificate	certificate: subs. certificado
chain	chain: subs. cadeia, chain: subs. corrente, chain: encadear
chair	chair: subs. cadeira, chair: subs. presidência, chair: subs. cátedra, chair: presidir
chairman	chairman: subs. presidente
chairperson	chairperson: subs. presidente
challenge	challenge: subs. desafio
chamber	chamber: subs. estância
champion	champion: subs. campeão
championship	championship: subs. campeonato
chance	chance: subs. oportunidade, chance: subs. possibilidade
chancellor	chancellor: subs. chanceler
change	change: subs. câmbio, change: subs. mudança, change: subs. troca, change: mudar
channel	channel: subs. canal
chaos	chaos: subs. caos, chaos: n.ND. caos
chapter	chapter: subs. capítulo
character	character: subs. carácter, character: subs. caráter, character: subs. personagem
characteristic	characteristic: subs. característica
characterize	characterize: caracterizar
charge	charge: subs. cargo, charge: subs. carga, charge: subs. ónus, charge: cobrar
charity	charity: subs. caridade
chart	chart: subs. gráfico, chart: subs. mapa
chase	chase: subs. perseguição
chauffeur	chauffeur: subs. conductor
cheap	cheap: adj.sint. barato
cheat	cheat: enganar
check	check: subs. controle
cheek	cheek: subs. bochecha
cheer	cheer: alegrar
cheerfully	cheerfully: adv. alegremente
cheese	cheese: subs. queijo
chemical	chemical: adj. químico
chemist	chemist: subs. farmacêutico, chemist: subs. químico
chemist's	chemist's: subs. farmácia
cheque	cheque: subs. cheque
chest	chest: subs. peito
chicken	chicken: subs. frango
chief	chief: subs. chefe, chief: subs. chefe
child	child: n.pl. filho, child: subs. infante, child: subs. menino, child: subs. infância
childish	childish: adj. infantil
chilean	Chilean: adj. chileno
chinese	Chinese: adj. chinês
chip	chip: subs. pedaço, chip: subs. chip
choice	choice: subs. eleição
choir	choir: subs. coração
choose	choose: escolher, choose: eleger
choral	choral: adj. coral
chord	chord: subs. acordo
chorus	chorus: subs. cor, chorus: subs. coração, chorus: subs. coro
christian	Christian: subs. cristão, Christian: adj. cristão
chronic	chronic: adj. crónico, chronic: adj. crônico
chronicle	chronicle: subs. crónica, chronicle: subs. crônica
church	church: subs. igreja
cigar	cigar: subs. cigarro
cigarette	cigarette: subs. cigarro
cinema	cinema: subs. cine
cinematographic	cinematographic: adj. cinematográfico
circle	circle: subs. círculo
circuit	circuit: subs. circuito
circulate	circulate: circular
circulation	circulation: subs. circulação
circumstance	circumstance: subs. circunstância
cite	cite: citar
citizen	citizen: subs. cidadão
citizenship	citizenship: subs. cidadania
city	city: subs. cidade
city council	city council: subs. prefeitura
civil	civil: adj. civil
civilization	civilization: subs. civilização
claim	claim: subs. reclamação, claim: afirmar, claim: reclamar
clan	clan: subs. clã
clap	clap: subs. aplauso
clarity	clarity: subs. clareza, clarity: subs. claridade
class	class: subs. classe
classical	classical: adj. clássico
classification	classification: subs. classificação
classroom	classroom: subs. classe
clause	clause: subs. cláusula
clave	clave: subs. bengala
clean	clean: adj.sint. limpo, clean: adj.sint. neto, clean: limpar
cleaning	cleaning: subs. limpeza
clear	clear: adj.sint. claro, clear: limpar
clearly	clearly: adv. claramente
clever	clever: adj.sint. pronto
click	click: subs. clique
client	client: subs. cliente
clientele	clientele: subs. freguesia
climate	climate: subs. clima
climatic	climatic: adj. climático
climb	climb: ascender
clock	clock: subs. relógio
close	close: adj.sint. próximo, close: fechar
closing	closing: subs. encerramento, closing: subs. fechamento
cloth	cloth: subs. tela, cloth: n.pl. roupa
clothes	clothes: n.pl. roupa
clothing	clothing: subs. roupa
cloud	cloud: subs. nuvem
club	club: subs. clube
cluster	cluster: subs. grupo
coach	coach: subs. treinador, coach: subs. autocarro
coal	coal: subs. carvão
coalition	coalition: subs. coalizão
coast	coast: subs. costa
coat	coat: subs. capa
cobweb	cobweb: subs. teia de aranha
cocaine	cocaine: subs. cocaína
cocktail	cocktail: subs. cocktail
code	code: subs. código
coffee	coffee: subs. café
coherence	coherence: subs. coerência
cohesion	cohesion: subs. coesão
coincide	coincide: coincidir
coincidence	coincidence: subs. coincidência
coin	coin: subs. moeda
cold	cold: subs. frio, cold: adj.sint. frio
collaboration	collaboration: subs. colaboração
collaborator	collaborator: subs. colaborador
colleague	colleague: subs. colega
collect	collect: recolher, collect: coleccionar, collect: colecionar, collect: arrecadar
collection	collection: subs. arrecadação, collection: subs. cobrança, collection: subs. colecção, collection: subs. coleção
collective	collective: adj. colectivo, collective: adj. coletivo
college	college: subs. universidade, college: adj. universitário
collision	collision: subs. colisão
colombian	Colombian: adj. colombiano
colonel	colonel: subs. coronel
colour	colour: subs. cor, colour: pintar
column	column: subs. coluna
combat	combat: combater
combination	combination: subs. combinação
combine	combine: combinar
come across	come across: encontrar
come back	come back: voltar
come	come: vir
comedy	comedy: subs. comédia
come in	come in: entrar
come out	come out: sair
comer	comer: adj. próximo, comer: adj. próximo
comfortable	comfortable: adj. cómodo, comfortable: adj. cômodo
comfortably	comfortably: adv. comodamente
comfort	comfort: subs. consolo, comfort: subs. comodidade, comfort: consolar
command	command: subs. ordem, command: subs. domínio, command: mandar
commander	commander: subs. comandante
commando	commando: subs. comando
commence	commence: começar
commentator	commentator: subs. comentarista
comment	comment: subs. comentário, comment: comentar
commerce	commerce: subs. comércio
commercial	commercial: subs. anúncio, commercial: adj. comercial
commercialize	commercialize: comercializar
commissariat	commissariat: subs. delegacia
commission	commission: subs. comissão
commit	commit: cometer
commitment	commitment: subs. compromisso
committee	committee: subs. comité, committee: subs. comitê
commodity	commodity: subs. mercadoria
common	common: adj. comum
commonly	commonly: adv. geralmente, commonly: adv. popularmente
communicate	communicate: comunicar
communication	communication: subs. comunicação
communiqué	communiqué: subs. comunicado
communist	communist: adj. comunista
community	community: subs. comunidade
companion	companion: subs. colega, companion: subs. companheiro
company	company: subs. companhia, company: subs. empresa
compare	compare: comparar
comparison	comparison: subs. comparação
compassion	compassion: subs. compaixão
compatriot	compatriot: subs. compatriota
compensate	compensate: compensar
compensation	compensation: subs. indemnização, compensation: subs. indenização
compete	compete: competir
competition	competition: subs. competição, competition: subs. concorrência
competitive	competitive: adj. competitivo
competitor	competitor: subs. competidor
complementary	complementary: adj. complementar
complement	complement: complementar
complete	complete: adj. completo, complete: completar
completely	completely: adv. completamente
completion	completion: subs. conclusão
complex	complex: adj. complexo
complicate	complicate: complicar
complication	complication: subs. complicação
component	component: subs. componente
comport	comport: comportar, comport: entranhar
compose	compose: compor
composer	composer: subs. compositor
composition	composition: subs. composição
compression	compression: subs. compressão
comprise	comprise: abranger, comprise: compreender
compulsory	compulsory: adj. obrigatório
computer	computer: subs. computador
concede	concede: admitir, concede: conceder
conceive	conceive: conceber
concentration	concentration: subs. concentração
concept	concept: subs. conceito
conception	conception: subs. concepção
conceptual	conceptual: adj. conceitual, conceptual: adj. conceptual
concern	concern: subs. preocupação, concern: preocupar
concert	concert: subs. concerto
concerto	concerto: subs. concerto
conclude	conclude: concluir, conclude: encerrar
conclusion	conclusion: subs. conclusão
concrete	concrete: adj. concreto
condemn	condemn: condenar
condition	condition: subs. condição
conduct	conduct: subs. conduta, conduct: conduzir, conduct: dirigir
conductor	conductor: subs. director, conductor: subs. diretor
conference	conference: subs. conferência
confidence	confidence: subs. confiança
confident	confident: adj. seguro
confine	confine: limitar
confirm	confirm: confirmar
confiscate	confiscate: apreender, confiscate: confiscar
conflict	conflict: subs. conflito
confront	confront: enfrentar
confuse	confuse: confundir
confusion	confusion: subs. confusão
congress	congress: subs. congresso
conjoint	conjoint: adj. conjunto
connect	connect: conectar, connect: ligar
connection	connection: subs. conexão, connection: subs. ligação
connoisseur	connoisseur: subs. conhecedor
conquer	conquer: conquistar
conquest	conquest: subs. conquista
consecrate	consecrate: consagrar
consecutive	consecutive: adj. consecutivo
consensus	consensus: subs. consenso
consent	consent: subs. consentimento
consequence	consequence: subs. consequência, consequence: subs. conseqüência
conservation	conservation: subs. conservação
conservative	conservative: adj. conservador
considerable	considerable: adj. considerável
considerably	considerably: adv. consideravelmente
consideration	consideration: subs. consideração
consider	consider: considerar
consign	consign: consignar
consist	consist: consistir
consistent	consistent: adj. consequente, consistent: adj. conseqüente
consolation	consolation: subs. consolo
consolidate	consolidate: consolidar
consortium	consortium: subs. consórcio
conspiracy	conspiracy: subs. conspiração
constant	constant: adj. constante
constantly	constantly: adv. constantemente
constellation	constellation: subs. constelação
constitute	constitute: constituir
constitutional	constitutional: adj. constitucional
constitutionally	constitutionally: adv. constitucionalmente
constitution	constitution: subs. constituição
construct	construct: construir
construction	construction: subs. construção
constructor	constructor: subs. construtor
consultation	consultation: subs. consulta
consult	consult: consultar
consume	consume: consumir
consumer	consumer: subs. consumidor
consummate	consummate: consumar
consumption	consumption: subs. consumo
contact	contact: subs. contacto, contact: subs. contato, contact: contactar, contact: contatar
contain	contain: conter
contemplate	contemplate: contemplar
contemporary	contemporary: adj. contemporâneo
contempt	contempt: subs. desprezo
content	content: subs. conteúdo, content: contentar
contention	contention: subs. contenda
contest	contest: subs. competição, contest: subs. concurso, contest: disputar
context	context: subs. contexto
continental	continental: adj. continental
continent	continent: subs. continente
contingent	contingent: subs. contingente
continually	continually: adv. continuamente
continuation	continuation: subs. continuação
continue	continue: continuar
continuity	continuity: subs. continuidade
continuous	continuous: adj. contínuo
continuously	continuously: adv. continuamente, continuously: adv. sustentadamente
contract	contract: subs. contrato, contract: contrair
contradict	contradict: contradizer
contradiction	contradiction: subs. contradição
contrary	contrary: adj. contrário
contrast	contrast: contrastar
contribute	contribute: contribuir
contribution	contribution: subs. contribuição, contribution: subs. contributo
contrive	contrive: criar
control	control: subs. controle, control: controlar
controversy	controversy: subs. polémica, controversy: subs. polêmica
convenience	convenience: subs. comodidade
convenient	convenient: adj. conveniente
convent	convent: subs. convento
convention	convention: subs. convenção, convention: subs. convênio
conversation	conversation: subs. conversação
convert	convert: converter
convey	convey: transportar, convey: transmitir
convict	convict: condenar
conviction	conviction: subs. condenação
convince	convince: convencer
cool	cool: adj.sint. fresco, cool: resfriar
coolness	coolness: subs. frialdade, coolness: subs. frieza
cooperation	cooperation: subs. cooperação
coordinate	coordinate: coordenar
coordination	coordination: subs. coordenação
coordinator	coordinator: subs. coordenador
copy	copy: subs. cópia
copyright	copyright: subs. copyright
coral	coral: subs. coral
cordial	cordial: adj. cordial
core	core: subs. núcleo
corporation	corporation: subs. empresa
corps	corps: subs. corpo
correct	correct: adj. certo, correct: adj. certo, correct: adj. certo, correct: adj. certo, correct: adj. certo, correct: adj. correcto, correct: adj. correcto, correct: adj. correcto, correct: adj. correcto, correct: adj. correcto, correct: adj. correcto, correct: adj. correto, correct: adj. correto, correct: adj. correto, correct: adj. correto, correct: adj. correto, correct: corrigir
correction	correction: subs. correcção, correction: subs. correção
correctly	correctly: adv. correctamente
correspond	correspond: corresponder
correspondence	correspondence: subs. correspondência
corresponding	corresponding: adj. correspondente
corruption	corruption: subs. corrupção
cost	cost: subs. custo, cost: custar, cost: valer
costume	costume: subs. vestido, costume: subs. disfarce
cough	cough: n.sg. tosse, cough: n.sg. tosse, cough: n.pl. tosse, cough: subs. tosse, cough: subs. tosse, cough: n.ND. tosse, cough: n.ND. tosse
coughing	coughing: subs. tosse
council	council: subs. conselho
councillor	councillor: subs. vereador, councillor: subs. conselheiro
counsel	counsel: subs. conselho, counsel: aconselhar
count	count: contar
countless	countless: adj. inúmero, countless: adj. inúmero, countless: adj. inúmero
country	country: subs. país
countryside	countryside: subs. campo
coup	coup: subs. golpe
couple	couple: subs. casal, couple: subs. dupla, couple: subs. par
courage	courage: subs. valor
course	course: subs. curso
court	court: subs. tribunal
courtyard	courtyard: subs. pátio
coverage	coverage: subs. cobertura
covering	covering: subs. cobertura
cowardly	cowardly: adj. covarde
cow	cow: subs. vaca
cradle	cradle: subs. berço
craft	craft: subs. habilidade, craft: subs. embarcação
crash	crash: subs. acidente, crash: subs. choque, crash: chocar
crazy	crazy: adj.sint. louco
create	create: criar
creation	creation: subs. criação
creative	creative: adj. criativo
creativity	creativity: subs. criatividade
creator	creator: subs. criador
creature	creature: subs. criatura
credibility	credibility: subs. credibilidade
credit	credit: subs. crédito
creditor	creditor: subs. credor
crew	crew: subs. tripulação
crewman	crewman: subs. tripulante
crime	crime: subs. delito, crime: subs. crime
criminal	criminal: subs. criminal
criminality	criminality: subs. criminalidade
crimp	crimp: encrespar, crimp: frisar
crisis	crisis: subs. crise, crisis: subs. crise, crisis: subs. crise
criterion	criterion: subs. critério
critical	critical: adj. crítico
critic	critic: subs. crítico
criticize	criticize: criticar
crop	crop: subs. cultivo, crop: subs. colheita
cross	cross: subs. cruz, cross: cruzar
crowd	crowd: subs. multidão
crown	crown: subs. coroa
crucial	crucial: adj. crucial
cruel	cruel: adj. cruel
cruelty	cruelty: subs. crueldade
cry	cry: subs. grito, cry: chorar, cry: gritar
crystal	crystal: subs. cristal
cuban	Cuban: adj. cubano
cult	cult: subs. culto
cultural	cultural: adj. cultural
culture	culture: subs. cultura
cunning	cunning: adj. astuto
cup	cup: subs. caneca, cup: subs. xícara, cup: subs. copa
curator	curator: subs. conservador
cure	cure: subs. cuidado, cure: subs. cura
curiosity	curiosity: subs. curiosidade
curious	curious: adj. curioso
currency	currency: subs. moeda
current	current: subs. corrente, current: adj. actual, current: adj. atual
currently	currently: adv. actualmente
curse	curse: subs. maldição, curse: amaldiçoar
curve	curve: subs. curva, curve: torcer
custom	custom: subs. costume
customer	customer: subs. cliente
cut	cut: subs. corte, cut: cortar, cut: talhar
dad	dad: subs. papai
daddy	daddy: subs. papai
daily	daily: adj. diário, daily: adj. cotidiano, daily: adj. quotidiano, daily: adv. diariamente
damage	damage: subs. dano
dance	dance: dançar
dancer	dancer: subs. bailarino
danger	danger: subs. perigo
dangerous	dangerous: adj. perigoso
dangerously	dangerously: adv. perigosamente
danish	Danish: adj. dinamarquês
dare	dare: ousar
dark	dark: subs. escuridão, dark: adj.sint. escuro
darken	darken: escurecer
darkness	darkness: subs. escuridade, darkness: subs. escuridão
data	data: subs. dado
date	date: datar
daughter	daughter: subs. filho
day	day: subs. dia, day: subs. jornada
dead	dead: adj. morto
dead person	dead person: subs. morte
deaf	deaf: adj.sint. surdo
deal	deal: subs. trato, deal: tratar
dealer	dealer: subs. comerciante
deal with	deal with: tratar
dearly	dearly: adv. muito
death	death: subs. morte
debate	debate: subs. debate, debate: debater
debt	debt: subs. dívida
decade	decade: subs. década
decadence	decadence: subs. decadência
decay	decay: subs. decadência
deceit	deceit: subs. luto
deceive	deceive: enganar
december	December: subs. dezembro
decide	decide: decidir
decision	decision: subs. decisão
decisive	decisive: adj. decisivo
declare	declare: declarar
decline	decline: subs. decadência, decline: subs. diminuição
decrease	decrease: subs. diminuição
decree	decree: subs. decreto, decree: decretar
dedicate	dedicate: dedicar
deduce	deduce: deduzir
deduction	deduction: subs. dedução
deep	deep: adj.sint. fundo, deep: adj.sint. profundo
deepen	deepen: aprofundar
deeply	deeply: adv. profundamente
defeat	defeat: subs. derrota, defeat: derrotar
defence	defence: subs. defesa
defenceless	defenceless: adj. indefeso
defend	defend: defender
defensive	defensive: adj. defensivo
deficit	deficit: subs. déficit
define	define: definir
definite	definite: adj. definitivo
definition	definition: subs. definição
definitively	definitively: adv. definitivamente
degrade	degrade: degradar
degree	degree: subs. título
delay	delay: subs. atraso, delay: atrasar
delegate	delegate: subs. delegado
delegation	delegation: subs. delegação
delete	delete: eliminar
delicacy	delicacy: subs. delicadeza
delicate	delicate: adj. delicado
deliver	deliver: repartir
delivery	delivery: subs. entrega
demand	demand: subs. demanda, demand: reclamar
demise	demise: subs. morte
democracy	democracy: subs. democracia
democratically	democratically: adv. democraticamente
democratic	democratic: adj. democrático
demographical	demographical: adj. demográfico
demolition	demolition: subs. escombro
demon	demon: subs. demónio, demon: subs. demônio
demonstrate	demonstrate: demonstrar
demonstration	demonstration: subs. manifestação
demonstrator	demonstrator: subs. manifestante
denationalize	denationalize: privatizar
denominate	denominate: denominar
denounce	denounce: denunciar
dense	dense: adj.sint. denso
density	density: subs. densidade
deny	deny: negar
department	department: subs. departamento
departure	departure: subs. saída
depend	depend: depender
dependence	dependence: subs. dependência
dependency	dependency: subs. dependência
depict	depict: descrever
deplete	deplete: esgotar
deploy	deploy: despregar
deportation	deportation: subs. deportação
deport	deport: deportar
deposit	deposit: subs. depósito, deposit: depositar
deprive	deprive: privar
depth	depth: subs. profundeza, depth: subs. profundidade
deputy	deputy: subs. deputado
derive	derive: derivar
descend	descend: descer
descent	descent: subs. descenso, descent: subs. rebaixamento
describe	describe: descrever
description	description: subs. descrição
desert	desert: subs. deserto
deserve	deserve: merecer
designate	designate: designar
design	design: subs. desenho, design: desenhar
designer	designer: subs. desenhador
desire	desire: subs. desejo, desire: desejar
desolation	desolation: subs. desolação
despair	despair: subs. desespero
despise	despise: desdenhar, despise: desprezar
destination	destination: subs. destino
destroy	destroy: destruir
destroyer	destroyer: subs. destruidor
destruction	destruction: subs. destruição
detail	detail: subs. detalhe, detail: detalhar, detail: pormenorizar
detain	detain: deter
detect	detect: detectar
detective	detective: subs. detective, detective: subs. detetive
detention	detention: subs. detenção
determination	determination: subs. determinação
determine	determine: determinar
detest	detest: detestar
detonate	detonate: detonar
devastate	devastate: devastar
develop	develop: desenvolver
development	development: subs. desenvolvimento
deviation	deviation: subs. desvio
device	device: subs. dispositivo, device: subs. aparelho
devote	devote: dedicar
diagnostic	diagnostic: subs. diagnóstico
diagonal	diagonal: subs. diagonal, diagonal: adj. diagonal
diagram	diagram: subs. esquema
dialect	dialect: subs. dialecto, dialect: subs. dialeto
dialectics	dialectics: subs. dialéctica, dialectics: subs. dialética
dialog	dialog: subs. diálogo
dialogue	dialogue: subs. diálogo
diamond	diamond: subs. diamante
diary	diary: subs. jornal, diary: subs. agenda
dictate	dictate: ditar
dictator	dictator: subs. ditador
dictatorship	dictatorship: subs. ditadura
dictionary	dictionary: subs. dicionário
didactic	didactic: adj. didáctico, didactic: adj. didático
die	die: falecer, die: morrer
diet	diet: subs. regime
difference	difference: subs. diferença
different	different: adj. diferente
difficult	difficult: adj. difícil
difficulty	difficulty: subs. dificuldade
dig	dig: cavar
digital	digital: adj. digital
dignity	dignity: subs. dignidade
dimension	dimension: subs. dimensão
diminish	diminish: diminuir
dinner	dinner: subs. jantar
diplomacy	diplomacy: subs. diplomacia
diplomatic	diplomatic: adj. diplomático
direct	direct: adj. directo, direct: adj. directo, direct: adj. directo, direct: adj. directo, direct: adj. directo, direct: adj. directo, direct: adj. direto, direct: adj. direto, direct: adj. direto, direct: adj. direto, direct: adj. direto, direct: dirigir
direction	direction: subs. direcção, direction: subs. sentido
directly	directly: adv. directamente, directly: adv. diretamente
director	director: subs. director, director: subs. diretor
dirt	dirt: subs. sujeira
dirty	dirty: adj.sint. bruto, dirty: adj.sint. sujo
disability	disability: subs. incapacidade
disagreement	disagreement: subs. desacordo, disagreement: subs. discordo
disappearance	disappearance: subs. desaparecimento
disappear	disappear: desaparecer
disappoint	disappoint: decepcionar
disappointment	disappointment: subs. decepção
disaster	disaster: subs. desastre
disc	disc: subs. disco
discharge	discharge: subs. volume, discharge: liberar, discharge: disparar, discharge: desembocar
discipline	discipline: subs. disciplina
disclose	disclose: revelar
disclosure	disclosure: subs. revelação
discontent	discontent: subs. desgosto
discord	discord: subs. discórdia
discount	discount: subs. desconto
discourse	discourse: subs. discurso
discover	discover: descobrir
discreet	discreet: adj. discreto
discrepancy	discrepancy: subs. discrepância
discrimination	discrimination: subs. discriminação
discuss	discuss: falar
discussion	discussion: subs. discussão
disease	disease: subs. doença
disequilibrium	disequilibrium: subs. desequilíbrio
disgust	disgust: subs. asco
disinfect	disinfect: desinfectar, disinfect: desinfetar
disk	disk: subs. disco
dislike	dislike: subs. aversão
dismissal	dismissal: subs. demissão, dismissal: subs. despedimento
dismiss	dismiss: recusar
disobedience	disobedience: subs. desobediência
dispatch	dispatch: subs. despacho
dispel	dispel: desvanecer
dispensation	dispensation: subs. administração
displace	displace: deslocar
display	display: subs. tela, display: mostrar
disposal	disposal: subs. disposição, disposal: subs. eliminação
dispose	dispose: colocar
dissolution	dissolution: subs. dissolução
dissolve	dissolve: dissolver
distance	distance: subs. distância
distant	distant: adj. distante
distinct	distinct: adj. diferente
distinctly	distinctly: adv. claramente
distinguish	distinguish: distinguir
distract	distract: distrair
distraction	distraction: subs. distracção, distraction: subs. distração
distribute	distribute: distribuir
distribution	distribution: subs. compartilhamento, distribution: subs. partilha, distribution: subs. distribuição, distribution: subs. disposição
district	district: subs. distrito
disturb	disturb: estorvar
diverse	diverse: adj. diverso
diversity	diversity: subs. diversidade
divert	divert: desviar
divide	divide: dividir, divide: partilhar
divine	divine: adj. divino
division	division: subs. divisão
divorce	divorce: subs. divórcio, divorce: divorciar
dock	dock: subs. berço
doctor	doctor: subs. doutor, doctor: subs. médico, doctor: subs. médico
doctrine	doctrine: subs. doutrina
documentary	documentary: subs. documental, documentary: adj. documental
documentation	documentation: subs. documentação
document	document: subs. documento, document: documentar
do	do: fazer, do: tornar
dog	dog: subs. cão
dollar	dollar: subs. dólar
doll	doll: subs. boneco
domain	domain: subs. âmbito
domestic	domestic: adj. doméstico
domicile	domicile: subs. domicílio
dominant	dominant: adj. dominante
dominate	dominate: dominar
donate	donate: dar
dose	dose: subs. dose, dose: subs. dose, dose: subs. dose
dot	dot: subs. ponto
double	double: adj. duplo, double: adj. duplo, double: adj. duplo
doubt	doubt: subs. dúvida, doubt: duvidar
down	down: adv. abaixo
downtown	downtown: adj. central
downward	downward: adj. descendente
dozen	dozen: subs. dúzia
draft	draft: redigir
drag	drag: arrastar
dragon	dragon: subs. dragão
drama	drama: subs. drama, drama: subs. teatro, drama: subs. obra
dramatic	dramatic: adj. dramático
dramatist	dramatist: subs. dramaturgo
draw	draw: subs. sorteio, draw: desenhar
drawing	drawing: subs. desenho
dreadful	dreadful: adj. terrível
dream	dream: subs. sonho, dream: sonhar
dress	dress: subs. traje, dress: subs. vestido, dress: vestir
drink	drink: subs. bebida, drink: beber
drive	drive: subs. passeio, drive: subs. empurrão, drive: conduzir
driver	driver: subs. conductor, driver: subs. motorista
driveway	driveway: subs. vau
driving	driving: subs. condução, driving: subs. comando
drop	drop: subs. gota
drought	drought: subs. seca
drown	drown: inundar
drug	drug: subs. droga
drugstore	drugstore: subs. farmácia
drum	drum: subs. tambor, drum: subs. barril
drunkard	drunkard: subs. bêbado
dry	dry: adj.sint. seco, dry: secar
dub	dub: baptizar
duel	duel: subs. duelo
due to	due to: pr. devido a
duke	duke: subs. duque
dump	dump: verter
durable	durable: adj. duradouro
duration	duration: subs. duração
during	during: pr. durante
dusk	dusk: subs. crepúsculo
dust	dust: n.sg. pó, dust: n.pl. pó
dutch	Dutch: subs. holandês
duty	duty: subs. dever, duty: n.sg. dever, duty: n.pl. dever
dynamic	dynamic: adj. dinâmico
each	each: det.ind. cada
eagerness	eagerness: subs. ânsia
eagle	eagle: subs. águia
ear	ear: subs. orelha
earl	earl: subs. conde
early	early: adj.sint. temporão, early: adv. cedo
earn	earn: cobrar, earn: ganhar
earnestly	earnestly: adv. sinceramente
earnings	earnings: n.pl. rendimento
earth	earth: subs. terra
earthquake	earthquake: subs. terramoto, earthquake: subs. terremoto
earthy	earthy: adj.sint. grosseiro
ease	ease: subs. facilidade, ease: aliviar
easily	easily: adv. facilmente
eastern	eastern: adj. oriental
easy	easy: adj.sint. fácil
eat	eat: comer
ecclesiastical	ecclesiastical: adj. eclesiástico
echo	echo: subs. eco, echo: repetir, echo: ressoar
ecological	ecological: adj. ecológico
economical	economical: adj. económico, economical: adj. econômico
economically	economically: adv. economicamente
economic	economic: adj. económico, economic: adj. econômico
economics	economics: n.pl. economia
economist	economist: subs. economista
economy	economy: subs. economia
ecstasy	ecstasy: subs. êxtase, ecstasy: subs. êxtase, ecstasy: subs. êxtase
ecuadorian	Ecuadorian: adj. equatoriano
eddy	eddy: subs. redemoinho
edit	edit: editar
edition	edition: subs. edição
editor	editor: subs. editor
editorial staff	editorial staff: subs. redacção, editorial staff: subs. redação
educate	educate: educar
educational	educational: adj. educativo
education	education: subs. educação, education: subs. ensinamento, education: subs. ensino
educative	educative: adj. educativo
effect	effect: subs. efeito, effect: efectuar, effect: efetuar
effective	effective: adj. eficaz, effective: adj. eficaz
effectively	effectively: adv. eficazmente
efficiency	efficiency: subs. eficácia
efficient	efficient: adj. eficaz, efficient: adj. eficaz
effort	effort: subs. esforço
effortlessly	effortlessly: adv. facilmente
egg	egg: subs. ovo
egyptian	Egyptian: adj. egípcio
eighteen	eighteen: num. dezoito
either	either: det.ind. nenhum, either: det.ind. qualquer, either: prsubs. nenhum, either: prn.tn.mf.sp. qualquer, either: cnjcoo. ou, either: adv. também não
elaborate	elaborate: elaborar
elder	elder: adj. grande
elect	elect: eleger
election	election: subs. eleição, election: subs. escolha
electoral	electoral: adj. eleitoral
electrical	electrical: adj. eléctrico, electrical: adj. elétrico
electricity	electricity: subs. electricidade, electricity: subs. eletricidade
electronic	electronic: adj. electrónico, electronic: adj. eletrônico
elegant	elegant: adj. elegante
elementary	elementary: adj. elementar
element	element: subs. elemento
elevate	elevate: elevar
elevator	elevator: subs. elevador
eleven	eleven: num. onze
eliminate	eliminate: eliminar
elimination	elimination: subs. eliminação
elite	elite: subs. elite
else	else: adv. mais
embarrass	embarrass: envergonhar
embarrassment	embarrassment: subs. vergonha
embassy	embassy: subs. embaixada
embody	embody: encarnar
embrace	embrace: subs. abraço
embryo	embryo: subs. embrião
emerge	emerge: surgir
emergency	emergency: subs. emergência
emergent	emergent: adj. emergente
emigrant	emigrant: subs. emigrante
emigrate	emigrate: emigrar
emission	emission: subs. emissão
emotional	emotional: adj. emocional
emotionally	emotionally: adv. emocionalmente
emotion	emotion: subs. emoção
emperor	emperor: subs. imperador
empire	empire: subs. império
employ	employ: empregar
employer	employer: subs. empresário
employment	employment: subs. emprego, employment: subs. ocupação
empty	empty: adj.sint. vazio
enable	enable: habilitar
enclose	enclose: fechar, enclose: incluir
encounter	encounter: encontrar
encourage	encourage: animar
endemical	endemical: adj. endémico
end	end: subs. final, end: subs. fim, end: acabar
ending	ending: subs. final
endorse	endorse: aprovar
enemy	enemy: subs. inimigo
energetic	energetic: adj. energético
energy	energy: subs. energia
enforce	enforce: aplicar
engage	engage: comprometer
engagement	engagement: subs. compromisso
engine	engine: subs. motor
engineer	engineer: subs. engenheiro
engineering	engineering: subs. engenharia
english	English: subs. inglês, English: adj. inglês
enjoy	enjoy: gostar
enormous	enormous: adj. enorme
enormously	enormously: adv. enormemente
enough	enough: adv. bastante
enquiry	enquiry: subs. consulta, enquiry: subs. investigação
enrichment	enrichment: subs. enriquecimento
ensure	ensure: assegurar
enter	enter: introduzir
enterprise	enterprise: subs. empresa
entertainer	entertainer: subs. artista
enthusiasm	enthusiasm: subs. entusiasmo
entire	entire: adj. inteiro
entirely	entirely: adv. completamente
entitle	entitle: titular, entitle: autorizar
entity	entity: subs. entidade
entrance	entrance: subs. entrada
entrust	entrust: confiar
entry	entry: subs. entrada
environmental	environmental: adj. ambiental
environment	environment: subs. meio
envy	envy: subs. inveja, envy: invejar
ephemeral	ephemeral: adj. efémero, ephemeral: adj. efêmero
epidemic	epidemic: subs. epidemia
episode	episode: subs. episódio
equal	equal: adj. igual
equality	equality: subs. igualdade
equally	equally: adv. igualmente
equilibrium	equilibrium: subs. equilíbrio
equip	equip: equipar
equipment	equipment: subs. equipamento
equivalent	equivalent: adj. equivalente
eradicate	eradicate: erradicar
erase	erase: apagar
erect	erect: levantar
erroneous	erroneous: adj. erróneo, erroneous: adj. errôneo
error	error: subs. erro
eruption	eruption: subs. erupção
especially	especially: adv. especialmente, especially: adv. sobretudo
espionage	espionage: subs. espionagem
essay	essay: subs. ensaio
establish	establish: estabelecer
establishment	establishment: subs. estabelecimento
estate	estate: subs. propriedade, estate: subs. herança
estimate	estimate: subs. orçamento, estimate: subs. verba, estimate: calcular
estrus	estrus: subs. zelo
eternal	eternal: adj. eterno
eternity	eternity: subs. eternidade
ethical	ethical: adj. ético
ethnic	ethnic: adj. étnico
ethnic group	ethnic group: subs. etnia
euro	euro: subs. euro
european	European: subs. europeu, European: adj. europeu
euthanasia	euthanasia: subs. eutanásia
evacuate	evacuate: evacuar
evacuation	evacuation: subs. evacuação
evade	evade: eludir
evaluate	evaluate: avaliar
evaluation	evaluation: subs. avaliação
even	even: adv. até mesmo, even: adv. inclusive
evening	evening: subs. noite
event	event: subs. acontecimento, event: subs. evento
eventual	eventual: adj. eventual
eventually	eventually: adv. finalmente
ever	ever: adv. nunca
evermore	evermore: adv. eternamente
everybody	everybody: prsubs. todo mundo
everyday	everyday: adj. diário
every	every: det.ind. cada
every now and again	every now and again: adv. continuamente
everyone	everyone: prsubs. todo mundo
everything	everything: prn.tn.m.sg. tudo
evidence	evidence: subs. evidência
evident	evident: adj. evidente
evidently	evidently: adv. evidentemente
evil	evil: subs. mal
evoke	evoke: evocar
evolution	evolution: subs. evolução
evolve	evolve: evoluir
exact	exact: adj. exacto
exactly	exactly: adv. exactamente, exactly: adv. exatamente
exaggerate	exaggerate: exagerar
exam	exam: subs. exame
examination	examination: subs. exame, examination: subs. interrogatório, examination: subs. inspecção
examine	examine: examinar
example	example: subs. exemplo
exceed	exceed: superar
exceedingly	exceedingly: adv. extremamente
excellent	excellent: adj. excelente
except	except: pr. excepto, except: pr. exceto
except for	except for: pr. excepto
exceptional	exceptional: adj. excepcional
exception	exception: subs. excepção, exception: subs. exceção
excess	excess: subs. excesso
excessive	excessive: adj. excessivo
excessively	excessively: adv. excessivamente
exchange	exchange: subs. mudança, exchange: subs. intercâmbio, exchange: trocar
excitation	excitation: subs. excitação
excite	excite: entusiasmar
excitement	excitement: subs. emoção
exclaim	exclaim: exclamar
exclude	exclude: excluir
exclusion	exclusion: subs. exclusão
exclusive	exclusive: adj. exclusivo
exclusively	exclusively: adv. exclusivamente
excuse	excuse: subs. desculpa
execution	execution: subs. execução
executive	executive: subs. executivo
exercise	exercise: subs. exercício
exert	exert: exercer
exhibit	exhibit: subs. evidência, exhibit: subs. prova, exhibit: subs. exposição, exhibit: exibir
exhibition	exhibition: subs. exposição
exile	exile: subs. exílio
existence	existence: subs. existência
existent	existent: adj. existente
exist	exist: existir
exit	exit: subs. saída, exit: sair
expansion	expansion: subs. expansão
expectation	expectation: subs. expectativa
expect	expect: aguardar, expect: esperar
expedition	expedition: subs. expedição
expel	expel: expulsar
expenditure	expenditure: subs. gasto
expense	expense: subs. gasto
expensive	expensive: adj. caro
experience	experience: subs. experiência, experience: experimentar
experiment	experiment: subs. experimento
expert	expert: subs. perito
explain	explain: explicar
explanation	explanation: subs. explicação
explode	explode: explodir, explode: desmentir
exploitation	exploitation: subs. exploração
exploit	exploit: explodir
exploration	exploration: subs. exploração
explore	explore: explorar
explosion	explosion: subs. explosão
explosive	explosive: subs. explosivo, explosive: adj. explosivo
export	export: subs. exportação, export: exportar
expose	expose: expor
exposure	exposure: subs. exposição
express	express: exprimir
expression	expression: subs. expressão
expulsion	expulsion: subs. expulsão
exquisite	exquisite: adj. extraordinário
extend	extend: estender
extension	extension: subs. ampliação, extension: subs. extensão
extensive	extensive: adj. extenso
extent	extent: subs. extensão, extent: subs. alcance
exterior	exterior: adj. exterior
external	external: adj. externo
extinction	extinction: subs. extinção
extortion	extortion: subs. extorsão
extract	extract: extrair
extraction	extraction: subs. extracção, extraction: subs. extração
extradition	extradition: subs. extradição
extraneous	extraneous: adj. alheio
extraordinarily	extraordinarily: adv. extraordinariamente
extraordinary	extraordinary: adj. extraordinário
extra time	extra time: subs. prorrogação
extreme	extreme: subs. extremo, extreme: adj. extremo
extremely	extremely: adv. extremamente
eyebrow	eyebrow: subs. sobrancelha
eye	eye: subs. olho
fabric	fabric: subs. tecido
façade	façade: subs. fachada
face	face: subs. cara
facet	facet: subs. faceta
face to face	face to face: adv. cara a cara
facial	facial: adj. facial
facile	facile: adj. simples
facilitate	facilitate: facilitar
facility	facility: subs. instalação, facility: subs. facilidade
fact	fact: subs. facto, fact: subs. fato
faction	faction: subs. facção
factor	factor: subs. factor, factor: subs. fator
factory	factory: subs. fábrica, factory: subs. usina
fail	fail: falhar
failure	failure: subs. falhanço, failure: subs. fracasso, failure: subs. falha, failure: subs. quebra
fair	fair: subs. feira, fair: adj.sint. justo
faith	faith: subs. fé
faithful	faithful: adj. fiel
fake	fake: subs. falsificação
fall down	fall down: cair
fall	fall: subs. queda, fall: cair, fall: desabar
false	false: adj.sint. falso
falsity	falsity: subs. falsidade
fame	fame: subs. fama
familiar	familiar: adj. familiar
family	family: subs. família, family: adj. familiar
famous	famous: adj. famoso, famous: adj. célebre
fanatical	fanatical: adj. fanático
fancy	fancy: adj.sint. elegante, fancy: gostar
fan	fan: subs. leque, fan: subs. seguidor
fantastic	fantastic: adj. fantástico
farce	farce: subs. farsa
far	far: adj.sint. longínquo, far: adv. longe
farm	farm: subs. granja
farming	farming: subs. agricultura
fashion	fashion: subs. moda, fashion: subs. maneira
fast	fast: adj.sint. rápido
fatal	fatal: adj. fatal
fate	fate: subs. destino
fat	fat: subs. gordura
father	father: subs. pai, father: n.sg. padre, father: n.sg. pai, father: subs. pai
fault	fault: subs. culpa, fault: subs. falta
favorable	favorable: adj. favorável
favourable	favourable: adj. favorável, favourable: adj. propício
favour	favour: subs. favor, favour: favorecer
favourite	favourite: adj. favorito
fear	fear: subs. medo, fear: temer
fearsome	fearsome: adj. temível
feather	feather: subs. pluma
feature	feature: n.pl. prestação, feature: subs. característica, feature: apresentar, feature: constar
february	February: subs. fevereiro
feces	feces: subs. fezes
federal	federal: adj. federal
federation	federation: subs. federação
feeble	feeble: adj.sint. débil, feeble: adj.sint. fraco, feeble: adj.sint. fraco
feed	feed: alimentar
fee	fee: subs. custo
feel	feel: parecer, feel: sentir
feeling	feeling: subs. sensação, feeling: subs. sentimento
fellow	fellow: subs. colega, fellow: subs. membro
female	female: subs. mulher
feminine	feminine: adj. feminino
fence	fence: subs. obstáculo
festival	festival: subs. festival
fiber	fiber: subs. fibra
fibre	fibre: subs. fibra
fiction	fiction: subs. ficção
field	field: subs. âmbito, field: subs. campo
fierce	fierce: adj. feroz, fierce: adj. feroz
fifteen	fifteen: num. quinze
fight	fight: subs. luta, fight: subs. combate, fight: lutar
figure	figure: subs. figura, figure: subs. cifra, figure: representar, figure: imaginar
file	file: subs. arquivo, file: subs. expediente
filial	filial: adj. filial
fill	fill: encher, fill: preencher
film	film: subs. filme, film: subs. película
final	final: subs. final, final: adj. final
finalist	finalist: subs. finalista
finally	finally: adv. afinal, finally: adv. conclusivamente, finally: adv. enfim, finally: adv. finalmente
finance	finance: financiar
financial	financial: adj. financeiro
find	find: achar, find: encontrar, find: descobrir
finding	finding: subs. descoberta
find out	find out: descobrir
fine	fine: subs. multa, fine: adj.sint. fino, fine: adj.sint. bom, fine: adv. bem
finger	finger: subs. dedo
finish	finish: subs. chegada, finish: acabar, finish: terminar
fire	fire: subs. fogo, fire: disparar, fire: despedir
firewood	firewood: subs. lenha
firmament	firmament: subs. firmamento
firm	firm: subs. empresa, firm: adj.sint. firme
first	first: adv. primeiro
firstly	firstly: adv. primeiramente, firstly: adv. em primeiro lugar
fiscal	fiscal: adj. fiscal
fish	fish: subs. peixe, fish: pescar
fit	fit: adj.sint. apto, fit: caber
fixed	fixed: adj. fixo
fix	fix: arranjar, fix: arreglar
flag	flag: subs. bandeira
flame	flame: subs. lume
flammable	flammable: adj. inflamável
flat	flat: subs. andar, flat: adj.sint. plano
flavor	flavor: subs. sabor
flavour	flavour: subs. sabor
flawlessly	flawlessly: adv. perfeitamente
fleet	fleet: subs. frota
flesh	flesh: subs. carne
flexibility	flexibility: subs. flexibilidade
flexible	flexible: adj. flexível
flight	flight: subs. voo, flight: subs. vôo
flood	flood: subs. inundação, flood: inundar
floor	floor: subs. andar, floor: subs. terra
floppy	floppy: adj. flexível
floral	floral: adj. floral
flour	flour: subs. farinha
flower	flower: subs. flor, flower: florescer
flowerpot	flowerpot: subs. teste
flow	flow: fluir
flu	flu: subs. gripe
fly	fly: subs. mosca, fly: voar
flying	flying: subs. voo
focus	focus: subs. foco, focus: n.ND. foco, focus: n.ND. foco, focus: centrar
folder	folder: subs. pasta
follow	follow: seguir
following	following: subs. seguidor, following: adj. seguinte
fond	fond: adj.sint. carinhoso
food	food: subs. comida, food: adj. alimentário, food: adj. alimentar
foolish	foolish: adj. tonto
foolishness	foolishness: n.sg. bobagem, foolishness: n.sg. tolice, foolishness: n.sg. tontura
footballer	footballer: subs. futebolista
football	football: n.sg. futebol
foot	foot: subs. pé
footprint	footprint: subs. impressão
footwear	footwear: subs. calçado
forbid	forbid: proibir
force	force: subs. força, force: obrigar
forceful	forceful: adj. enérgico
forecast	forecast: subs. previsão
foreigner	foreigner: subs. estrangeiro
foreign	foreign: adj. estrangeiro
foresee	foresee: prever
forest	forest: subs. bosque
for	for: cnjadv. já que, for: pr. para, for: pr. pra, for: pr. por, for: pr. durante
forget	forget: esquecer
forgive	forgive: perdoar
formalize	formalize: formalizar
formally	formally: adv. formalmente
format	format: subs. formato
formation	formation: subs. formação
former	former: adj. anterior
formerly	formerly: adv. anteriormente
form	form: subs. forma, form: formar
formula	formula: subs. fórmula
formulate	formulate: formular
forthcoming	forthcoming: adj. próximo
for the meantime	for the meantime: adv. por enquanto
for the moment	for the moment: adv. por enquanto
for the most part	for the most part: adv. maioritariamente
forth	forth: adv. adiante
forthwith	forthwith: adv. em seguida
fortify	fortify: fortalecer
fortress	fortress: subs. fortaleza
fortunate	fortunate: adj. afortunado
fortunately	fortunately: adv. felizmente
fortune	fortune: subs. fortuna
forum	forum: subs. foro
forward	forward: enviar, forward: adv. adiante
fossil	fossil: subs. fóssil
foster	foster: adj. adoptivo
foundation	foundation: subs. fundação
founder	founder: subs. fundador
found	found: fundar
fountain	fountain: subs. fonte
fourteen	fourteen: num. quatorze
fraction	fraction: subs. fracção, fraction: subs. fração
fracture	fracture: subs. fractura, fracture: subs. fratura
fragile	fragile: adj. frágil
fragment	fragment: subs. fragmento
frame	frame: subs. estrutura, frame: subs. marco
framework	framework: subs. marco
frank	frank: adj. franco
frankly	frankly: adv. francamente
fraud	fraud: subs. fraude
freedom	freedom: subs. liberdade
free	free: adj.sint. gratuito, free: adj.sint. livre, free: liberar, free: libertar
freely	freely: adv. livremente
freeze	freeze: congelar
french	French: subs. francês, French: adj. francês
frequency	frequency: subs. frequência, frequency: subs. freqüência
frequent	frequent: adj. frequente, frequent: adj. freqüente
frequently	frequently: adv. frequentemente, frequently: adv. freqüentemente
fresh	fresh: adj.sint. fresco
freshly	freshly: adv. recentemente
friday	Friday: subs. sexta-feira, Friday: n.ND. sexta-feira, Friday: n.ND. sexta-feira
friend	friend: subs. amigo
friendly	friendly: adj.sint. amistoso
friendship	friendship: subs. amizade
frighten	frighten: assustar
frightful	frightful: adj. horrível
frock	frock: subs. hábito
from	from: pr. de
from one day to the next	from one day to the next: adv. da noite para o dia
from year to year	from year to year: adv. ano após ano
frontal	frontal: adj. frontal
front	front: subs. frente
frontier	frontier: subs. fronteira
fruit	fruit: subs. fruta, fruit: subs. fruto
fucking	fucking: adj. maldito
fuel	fuel: subs. combustível
fugue	fugue: subs. fuga
fulfil	fulfil: cumprir
full blast	full blast: adv. rapidamente
full	full: adj.sint. cheio, full: adj.sint. pleno
fully	fully: adv. cheiamente, fully: adv. plenamente
function	function: subs. função, function: funcionar
functioning	functioning: subs. funcionamento
fundamental	fundamental: adj. fundamental
fundamentalist	fundamentalist: subs. fundamentalista
fundamentally	fundamentally: adv. fundamentalmente
fund	fund: subs. fundo, fund: subs. fundo, fund: subs. fundo, fund: financiar
funding	funding: subs. financiamento
funeral	funeral: subs. funeral
fur	fur: subs. pele
furious	furious: adj. furioso
further	further: adv. para além
furthermore	furthermore: adv. ademais
fury	fury: subs. furia
fuselage	fuselage: subs. navio
fusion	fusion: subs. fusão
futile	futile: adj. vão
future	future: subs. futuro, future: adj. futuro
gain	gain: subs. benefício, gain: subs. ganho, gain: obter
gala	gala: subs. gala
galician	galician: subs. galego
gambling	gambling: subs. jogo
game	game: subs. jogo
gap	gap: subs. oco, gap: subs. vazio
garage	garage: subs. garagem
garbage	garbage: n.sg. lixo, garbage: n.pl. lixo
garbled	garbled: adj. confuso
gardener	gardener: subs. jardineiro
garden	garden: subs. jardim
garnish	garnish: enfeitar
gas	gas: subs. gás
gasoline	gasoline: subs. gasolina
gather	gather: reunir
gear	gear: subs. equipa, gear: subs. andamento, gear: subs. marcha, gear: subs. passeata
gender	gender: subs. género, gender: subs. gênero
gene	gene: subs. gene
general	general: subs. general, general: adj. geral
generalize	generalize: generalizar
generally	generally: adv. geralmente
generate	generate: gerar
generation	generation: subs. geração
generous	generous: adj. generoso
genetic	genetic: adj. genético
genital	genital: adj. genital
genius	genius: subs. génio, genius: subs. gênio
genocide	genocide: subs. genocídio
genre	genre: subs. género
gentle	gentle: adj. suave
gentleman	gentleman: subs. senhor
genuinely	genuinely: adv. sinceramente
geographic	geographic: adj. geográfico
geological	geological: adj. geológico
german	German: subs. alemão, German: adj. alemão
gesture	gesture: subs. gesto
get	get: alcançar, get: atingir, get: conseguir, get: pegar, get: chegar, get: receber
get hold of	get hold of: conseguir
ghost	ghost: subs. fantasma
giant	giant: subs. gigante
gift	gift: subs. presente, gift: subs. dom
gigantic	gigantic: adj. gigantesco
gig	gig: subs. actuação
gild	gild: dourar
girl	girl: subs. criança, girl: subs. menino, girl: subs. garoto, girl: subs. moço, girl: subs. rapariga, girl: subs. rapaz
give back	give back: sep. regressar, give back: sep. voltar
give	give: dar, give: presentear
give up	give up: sep. deixar
gladden	gladden: alegrar
glad	glad: adj. feliz
glance	glance: subs. mirada, glance: olhar
glass	glass: subs. vidro, glass: subs. copa
glide	glide: deslizar
glimpse	glimpse: entrever
global	global: adj. global
globalization	globalization: subs. globalização
globe	globe: subs. balão, globe: n.ND. balão, globe: n.ND. balão
glorious	glorious: adj. magnífico
glory	glory: subs. glória
glove	glove: subs. luva
glow	glow: subs. fulgor
glue	glue: subs. cola
goal	goal: subs. objectivo, goal: subs. gol, goal: subs. golo
goalkeeper	goalkeeper: subs. goleiro
go back	go back: regressar, go back: voltar
goddess	goddess: subs. deus
god	god: subs. deus
go down	go down: baixar
go	go: ir
go in	go in: entrar
gold	gold: subs. ouro
goodbye	goodbye: ij. adeus
good	good: subs. bem, good: adj.sint. bom, good: adj.sint. bom, good: adj.sint.comp. melhor, good: adj.sint.sup. melhor, good: adv. bem
goodness	goodness: subs. bondade
go on	go on: continuar
go out	go out: sair
go up	go up: subir
government	government: subs. governação, government: subs. governo
grace	grace: subs. graça
grade	grade: subs. nota
grain	grain: subs. grão, grain: subs. fibra
gram	gram: subs. grama
gramme	gramme: subs. grama
grandchild	grandchild: subs. neto
granddaughter	granddaughter: subs. neto
grandfather	grandfather: subs. avô, grandfather: n.sg. avô
grandmother	grandmother: subs. avô
grandparent	grandparent: subs. avô, grandparent: n.pl. avô
grandson	grandson: subs. neto
granite	granite: subs. granito
grant	grant: subs. bolsa, grant: conceder
graphic	graphic: adj. gráfico
graphics	graphics: subs. gráfico
grasp	grasp: pegar
grass	grass: subs. erva
grave	grave: subs. tumba, grave: adj.sint. grave
gravely	gravely: adv. gravemente
gravity	gravity: subs. gravidade
great	great: adj.sint.comp. maior, great: adj.sint. grande
greatly	greatly: adv. muito
greatness	greatness: n.sg. grandeza
greek	Greek: adj. grego
green	green: adj.sint. verde
greet	greet: saudar
grille	grille: subs. grade
grimace	grimace: subs. careta
gross	gross: adj.sint. sujo
ground	ground: subs. terra
group	group: subs. conjunto, group: subs. grupo
grouping	grouping: subs. agrupamento, grouping: subs. agrupação
grow	grow: crescer
growth	growth: subs. crescimento
guarantee	guarantee: subs. aval, guarantee: garantir
guard	guard: subs. guarda
guerrilla warfare	guerrilla warfare: subs. guerrilha, guerrilla warfare: subs. guerrilheiro
guess	guess: subs. suposição, guess: adivinhar
guest	guest: subs. hóspede
guesthouse	guesthouse: subs. pensão
guide	guide: guiar
guideline	guideline: subs. directriz, guideline: subs. diretriz
gun	gun: subs. pistola
habilitation	habilitation: subs. habilitação
habit	habit: subs. costume
hair	hair: subs. cabelo
half	half: subs. metade, half: adj. médio
hall	hall: subs. sala
halt	halt: parar
ham	ham: subs. presunto
hammer	hammer: picar
hamper	hamper: dificultar
hand	hand: subs. mão, hand: entregar
handicraft	handicraft: subs. artesanato
handle	handle: subs. cabo, handle: manejar
hand over fist	hand over fist: adv. rapidamente
handwriting	handwriting: subs. letra
handwritten	handwritten: adj. manuscrito
hang	hang: dependurar, hang: pender, hang: pendurar
hangman	hangman: subs. verdugo
happen	happen: passar
happily	happily: adv. felizmente
happiness	happiness: subs. felicidade
happy	happy: adj.sint. feliz, happy: adj.sint. contente
harbour	harbour: subs. porto
hard	hard: adj.sint. duro
hardly	hardly: adv. dificilmente
harmful	harmful: adj. daninho, harmful: adj. danoso
harm	harm: subs. mal
harp	harp: subs. garra, harp: subs. harpa
harsh	harsh: adj. duro
harvest	harvest: subs. colheita, harvest: subs. safra
hate	hate: subs. ódio, hate: odiar
hatred	hatred: subs. aversão
have got	have got: ter, have got: ter
have	have: vbhaver. ter, have: ter
have to	have to: vbmod. ter de, have to: vbmod. ter que, have to: vbmod. dever, have to: vbmod. deber, have to: vbmod. haver de
hazardous	hazardous: adj. perigoso
head	head: subs. cabeça, head: subs. chefe, head: subs. chefe, head: subs. chefe, head: subs. cabo, head: encabeçar
health	health: subs. saúde
healthy	healthy: adj.sint. são
hear	hear: sentir
hearing	hearing: subs. audiência, hearing: subs. vista, hearing: subs. ouvido
heart	heart: subs. cor, heart: subs. coração, heart: subs. coro
heat	heat: subs. calor, heat: aquecer, heat: esquentar
heating	heating: subs. calefacção, heating: subs. calefação
heaven	heaven: subs. céu
heavily	heavily: adv. fortemente
hectare	hectare: subs. hectare
height	height: subs. cota
helicopter	helicopter: subs. helicóptero
hell	hell: subs. inferno
hello	hello: ij. oi, hello: ij. olá
helmet	helmet: subs. capacete, helmet: subs. casco
helpful	helpful: adj. útil
help	help: subs. ajuda, help: ajudar
hemisphere	hemisphere: subs. hemisfério
heparin	heparin: subs. heparina
herd	herd: subs. rebanho
here	here: adv. aqui, here: adv. aí, here: adv. cá
her	her: det.pos.sp. o seu
heritage	heritage: subs. património, heritage: subs. patrimônio
hero	hero: subs. herói
heroine	heroine: subs. herói
hers	hers: adj. seu, hers: prn.pos.mf.sp. o seu
hesitate	hesitate: vacilar, hesitate: duvidar
hide	hide: subs. esconderijo, hide: esconder
hierarchy	hierarchy: subs. hierarquia
high	high: adj.sint. alto
highlight	highlight: destacar, highlight: salientar
highly	highly: adv. altamente
high school	high school: subs. instituto
highway	highway: subs. estrada
hint	hint: subs. pista
hire	hire: contratar
hire out	hire out: contratar
his	his: det.pos.sp. o seu, his: det. o seu, his: det. seu, his: adj. seu, his: prn.pos.mf.sp. o seu, his: prn.pos. o seu
historian	historian: subs. historiador
historical	historical: adj. histórico
historically	historically: adv. historicamente
history	history: subs. história
hit	hit: subs. impacto, hit: subs. sucesso, hit: colar, hit: acertar
holder	holder: subs. manchete, holder: subs. titular
hold	hold: subs. controle, hold: aguentar
hole	hole: subs. buraco
holiday	holiday: n.sg. férias, holiday: n.pl. férias, holiday: subs. férias
hollow	hollow: adj. vazio
holy	holy: adj.sint. sagrado
homage	homage: subs. homenagem
home	home: subs. casa, home: subs. lar
homeland	homeland: subs. pátria
homework	homework: n.sg. dever, homework: n.pl. dever
homicide	homicide: subs. homicídio
homologation	homologation: subs. homologação
homosexual	homosexual: adj. homossexual
honey	honey: subs. mel
honor	honor: subs. honra
honour	honour: subs. honra, honour: honrar
hope	hope: subs. esperança, hope: aguardar, hope: esperar
hopelessly	hopelessly: adv. totalmente
horizon	horizon: subs. horizonte
hormone	hormone: subs. hormona, hormone: subs. hormônio
horn	horn: subs. corno
horrible	horrible: adj. horrível
horror	horror: subs. horror
horse	horse: subs. cavalo
hospital	hospital: subs. hospital
hospitalization	hospitalization: subs. hospitalização
hostage	hostage: subs. refém
hostess	hostess: subs. hóspede
host	host: subs. anfitrião
hostile	hostile: adj. hostil
hostility	hostility: subs. hostilidade
hotel	hotel: subs. hotel
hot	hot: adj.sint. quente
hour	hour: subs. hora
household	household: subs. casa
house	house: subs. casa, house: subs. moradia
housing	housing: subs. alojamento
how	how: adv. como
how many	how many: prn.itg.mf.pl. quanto
how much	how much: prn.itg.mf.sg. quanto
huge	huge: adj. enorme
hugely	hugely: adv. muito
human	human: adj. humano
humanitarian	humanitarian: adj. humanitário
humble	humble: adj.sint. humilde
humbly	humbly: adv. humildemente
humid	humid: adj. húmido, humid: adj. úmido
humor	humor: subs. humor
humorist	humorist: subs. humorista
humour	humour: subs. humor
hundred	hundred: subs. centena
hurricane	hurricane: subs. furacão
husband	husband: subs. marido
hymn	hymn: subs. hino
hypocrisy	hypocrisy: subs. hipocrisia
hypothermia	hypothermia: subs. hipotermia
hypothesis	hypothesis: subs. hipótese
iberian	Iberian: adj. ibérico, Iberian: adj. ibério
ice	ice: subs. gelo
idea	idea: subs. ideia, idea: subs. idéia
ideal	ideal: adj. ideal
identical	identical: adj. idêntico
identification	identification: subs. identificação
identify	identify: identificar
identity	identity: subs. identidade
ideological	ideological: adj. ideológico
idiot	idiot: subs. idiota
idol	idol: subs. ídolo
ignorance	ignorance: subs. ignorância
ignore	ignore: ignorar
illegal	illegal: adj. ilegal
illegally	illegally: adv. ilegalmente
illicit	illicit: adj. ilícito
ill	ill: adj.sint. doente
illness	illness: subs. doença, illness: subs. enfermidade
illusion	illusion: subs. ilusão
illustrate	illustrate: ilustrar
illustration	illustration: subs. ilustração
illustrator	illustrator: subs. ilustrador
image	image: subs. imagem
imagine	imagine: imaginar
imitate	imitate: imitar
immediate	immediate: adj. imediato
immediately	immediately: adv. em seguida, immediately: adv. imediatamente, immediately: adv. logo
immense	immense: adj. imenso
immigrant	immigrant: subs. imigrante
immigration	immigration: subs. imigração
imminent	imminent: adj. iminente
immortal	immortal: adj. imortal
impact	impact: subs. impacto
impartial	impartial: adj. imparcial
impatience	impatience: subs. impaciência
impetus	impetus: subs. impulso
implantation	implantation: subs. implantação
implant	implant: implantar
implication	implication: subs. envolvimento
imply	imply: implicar
importance	importance: subs. importância
important	important: adj. importante
import	import: subs. importação, import: importar
impose	impose: impor
impossible	impossible: adj. impossível
impotent	impotent: adj. impotente
impression	impression: subs. impressão
impressive	impressive: adj. impressionante
imprison	imprison: encarcerar
improve	improve: melhorar
improvement	improvement: subs. melhora
improvise	improvise: improvisar
impulse	impulse: subs. impulso
impunity	impunity: subs. impunidade
inability	inability: subs. incapacidade
in abundance	in abundance: adv. em abundância
in addition	in addition: adv. ademais
in addition to	in addition to: pr. além de
inadmissible	inadmissible: adj. inadmissível
in agreement	in agreement: adv. conforme
in a little while	in a little while: adv. em seguida
in all conscience	in all conscience: adv. sinceramente
inauguration	inauguration: subs. inauguração
in between	in between: adv. no meio
in bulk	in bulk: adv. por atacado
incapable	incapable: adj. incapaz, incapable: adj. incapaz
incentive	incentive: subs. incentivo
incidentally	incidentally: adv. adicionalmente
incident	incident: subs. incidente
incite	incite: incitar
inclination	inclination: subs. inclinação
incline	incline: inclinar
included	included: adv. inclusivamente, included: adv. inclusive
include	include: incluir
income	income: subs. ingresso, income: subs. rendimento
incompetence	incompetence: subs. incompetência
in conjunction	in conjunction: adv. conjuntamente
incorporate	incorporate: incorporar
incorporation	incorporation: subs. incorporação
increase	increase: subs. aumento, increase: aumentar
increasing	increasing: adj. crescente
incredible	incredible: adj. incrível
incredibly	incredibly: adv. incrivelmente
indeed	indeed: adv. de fato
indefinite	indefinite: adj. indefinido
independence	independence: subs. independência
independent	independent: adj. independente
independently	independently: adv. independentemente
index	index: subs. índice
indian	Indian: adj. índio
indicate	indicate: indicar
indication	indication: subs. indicação
indicator	indicator: subs. indicador
indictment	indictment: subs. acusação
indifferent	indifferent: adj. indiferente
indignation	indignation: subs. indignação
indirectly	indirectly: adv. indirectamente, indirectly: adv. indiretamente
indiscriminately	indiscriminately: adv. a torto e a direito
indispensable	indispensable: adj. indispensável
indistinctly	indistinctly: adv. indistintamente
individual	individual: subs. indivíduo, individual: adj. individual
individually	individually: adv. individualmente
indonesian	Indonesian: adj. indonésio
indoor	indoor: adj. interior
induce	induce: induzir
industrial	industrial: adj. industrial
industrialize	industrialize: industrializar
industry	industry: subs. indústria, industry: subs. industria
in earnest	in earnest: adv. seriamente
inequality	inequality: subs. desigualdade
inertia	inertia: subs. inércia
inevitable	inevitable: adj. inevitável
in exchange	in exchange: adv. em troca
inexplicably	inexplicably: adv. inexplicavelmente
in fact	in fact: adv. de fato
in fairness	in fairness: adv. sinceramente
infant	infant: subs. menino
infect	infect: infectar
infection	infection: subs. infecção
inferior	inferior: adj. inferior
infinite	infinite: subs. infinito, infinite: adj. infinito
infirmary	infirmary: subs. enfermagem, infirmary: subs. enfermaria
inflammable	inflammable: adj. inflamável
inflation	inflation: subs. inflação
influence	influence: subs. influência, influence: influir
informal	informal: adj. informal
informational	informational: adj. informativo
information	information: subs. informação
informative	informative: adj. informativo, informative: adj. noticioso
inform	inform: informar, inform: noticiar
infrastructure	infrastructure: subs. infra-estrutura
infrequent	infrequent: adj. infrequente, infrequent: adj. infreqüente
in front	in front: adv. ante, in front: adv. frente, in front: adv. defronte, in front: adv. diante, in front: adv. em frente
in front of	in front of: pr. ante, in front of: pr. perante, in front of: pr. adiante de
inhabitant	inhabitant: subs. habitante, inhabitant: subs. morador, inhabitant: subs. morador
inhalation	inhalation: subs. inalação
inheritance	inheritance: subs. herança
inherit	inherit: herdar
inhuman	inhuman: adj. desumano
in	in: pr. a, in: pr. em, in: adv. dentro
initial	initial: adj. inicial
initially	initially: adv. inicialmente
initiate	initiate: iniciar
initiative	initiative: subs. iniciativa
injury	injury: subs. lesão, injury: subs. dano
injustice	injustice: subs. injustiça
in kind	in kind: adv. amavelmente
ink	ink: subs. tinta
inner	inner: adj. interior
innocence	innocence: subs. inocência
innocent	innocent: adj. inocente
innovation	innovation: subs. inovação
innovative	innovative: adj. inovador
innumerable	innumerable: adj. inumerável
in order that	in order that: cnjadv. contanto que
in passing	in passing: adv. de passagem
in plenty	in plenty: adv. em abundância
input	input: subs. entrada
inquiry	inquiry: subs. consulta, inquiry: subs. investigação
in return	in return: adv. em troca
insanity	insanity: subs. insanidade
insect	insect: subs. insecto, insect: subs. inseto
insecurity	insecurity: subs. insegurança
in short order	in short order: adv. em seguida
inside	inside: subs. interior
insight	insight: subs. ideia
insignificant	insignificant: adj. insignificante
insist	insist: insistir
inspect	inspect: inspeccionar, inspect: inspecionar
inspection	inspection: subs. inspecção, inspection: subs. inspeção
inspiration	inspiration: subs. inspiração
inspire	inspire: inspirar
installation	installation: subs. instalação
install	install: instalar
instance	instance: subs. caso, instance: subs. instância
instant	instant: subs. instante
instead of	instead of: pr. ao invés de, instead of: pr. em vez de
instinct	instinct: subs. instinto
institute	institute: subs. instituto
institutional	institutional: adj. institucional
institution	institution: subs. instituição
instruct	instruct: instruir
instruction	instruction: subs. instrução
instrument	instrument: subs. instrumento, instrument: equipar
insufficient	insufficient: adj. insuficiente
insufficiently	insufficiently: adv. insuficientemente
insure	insure: assegurar
intact	intact: adj. intacto, intact: adj. intacto, intact: adj. intacto, intact: adj. intacto, intact: adj. intacto, intact: adj. intacto
integrate	integrate: integrar
integration	integration: subs. integração
integrity	integrity: subs. integridade
intellectual	intellectual: adj. intelectual
intelligence	intelligence: subs. inteligência
intelligent	intelligent: adj. inteligente
intend	intend: pretender
intense	intense: adj. intenso
intensify	intensify: intensificar
intensity	intensity: subs. intensidade
intensive	intensive: adj. intensivo
intention	intention: subs. intenção
interaction	interaction: subs. interacção, interaction: subs. interação
interactive	interactive: adj. interactivo
intercept	intercept: interceptar
interesting	interesting: adj. interessante
interestingly enough	interestingly enough: adv. curiosamente
interestingly	interestingly: adv. curiosamente
interest	interest: subs. interesse, interest: subs. juro, interest: n.pl. inquietude
interim	interim: adj. interino
interior	interior: subs. interior
internal	internal: adj. interno
international	international: adj. internacional
internet	internet: subs. a internet, internet: subs. a internet, internet: subs. internet
interpose	interpose: interpor
interpretation	interpretation: subs. interpretação
interpreter	interpreter: subs. intérprete
interpret	interpret: interpretar
interrogate	interrogate: interrogar
interrogation	interrogation: subs. inquérito, interrogation: subs. interrogatório
interrupt	interrupt: interromper
interruption	interruption: subs. interrupção
interval	interval: subs. intervalo
intervene	intervene: intervir
intervention	intervention: subs. intervenção
interview	interview: subs. entrevista, interview: entrevistar
in the first instance	in the first instance: adv. em primeiro lugar
in the first place	in the first place: adv. em primeiro lugar
in the middle	in the middle: adv. no meio
in the nick of time	in the nick of time: adv. por um fio
in the same way	in the same way: adv. do mesmo modo
in the short term	in the short term: adv. em curto prazo
in this fashion	in this fashion: adv. desta guisa
in this way	in this way: adv. desta guisa
intimate	intimate: adj. íntimo
intimidation	intimidation: subs. intimidação
into	into: pr. a
intolerable	intolerable: adj. intolerável
intolerance	intolerance: subs. intolerância
in total	in total: adv. ao todo
into the bargain	into the bargain: adv. ademais
introduce	introduce: introduzir, introduce: apresentar
introduction	introduction: subs. introdução
in turn	in turn: adv. em troca
inundate	inundate: inundar
inundation	inundation: subs. inundação
in vain	in vain: adv. em vão
invasion	invasion: subs. invasão
invent	invent: inventar
invention	invention: subs. invenção
inventor	inventor: subs. inventor
investigate	investigate: investigar, investigate: pesquisar
investigation	investigation: subs. investigação, investigation: subs. pesquisa
investigator	investigator: subs. detective
invest	invest: investir
investment	investment: subs. investimento
investor	investor: subs. investidor
invisible	invisible: adj. invisível
invitation	invitation: subs. convite
invoice	invoice: subs. factura
invoke	invoke: invocar
involve	involve: acarretar, involve: implicar
involvement	involvement: subs. envolvimento
inwardly	inwardly: adv. interiormente
iranian	Iranian: adj. iraniano
iraqi	Iraqi: adj. iraquiano
irish	Irish: subs. irlandês, Irish: adj. irlandês
iron	iron: subs. ferro, iron: subs. ferro
irregular	irregular: adj. irregular
irregularity	irregularity: subs. irregularidade
irritation	irritation: subs. irritação
islamic	Islamic: adj. islâmico
island	island: subs. ilha
isolate	isolate: isolar
israeli	Israeli: subs. israelense, Israeli: adj. israelense
issue	issue: subs. assunto, issue: emitir, issue: publicar
italian	Italian: subs. italiano, Italian: adj. italiano
item	item: subs. elemento
its	its: det.pos.sp. o seu
jail	jail: subs. prisão
january	January: subs. janeiro
japanese	Japanese: subs. japonês, Japanese: adj. japonês
jealous	jealous: adj. ciumento, jealous: adj. zeloso
jewel	jewel: subs. jóia
jewellery	jewellery: n.sg. jóia, jewellery: n.pl. jóia
jewelry	jewelry: n.sg. jóia, jewelry: n.pl. jóia
jewish	Jewish: adj. judeu
job	job: subs. lida, job: subs. trabalho
join	join: unir
joint	joint: subs. junta, joint: juntar
jointly	jointly: adv. juntamente, jointly: adv. conjuntamente
journalism	journalism: subs. jornalismo
journalistic	journalistic: adj. jornalístico
journalist	journalist: subs. jornalista
journal	journal: subs. revista
journey	journey: subs. viagem
joy	joy: subs. alegria
joyous	joyous: adj. ditoso
judge	judge: subs. juiz, judge: julgar
judgement	judgement: subs. julgamento, judgement: subs. sentença
judgment	judgment: subs. julgamento, judgment: subs. sentença
judicial	judicial: adj. judicial, judicial: adj. judiciário, judicial: adj. judiciário
juice	juice: subs. suco
july	July: subs. julho
jumper	jumper: subs. camisola
jump	jump: subs. salto, jump: saltar
june	June: subs. junho
jungle	jungle: subs. selva
junior	junior: subs. jovem
juridical	juridical: adj. jurídico
jury	jury: subs. júri
just as	just as: preadv. tão
justice	justice: subs. justiça
justification	justification: subs. justificativa, justification: subs. justificação
justify	justify: justificar
just	just: adj.sint. justo, just: adv. exactamente, just: adv. justo, just: adv. só
just right	just right: adv. correctamente
juvenile	juvenile: adj. juvenil
keep	keep: manter, keep: continuar, keep: seguir
keep on	keep on: continuar
key	key: subs. tom, key: subs. chave, key: subs. cravo, key: subs. tecla
kg	kg: subs. kg
kid	kid: subs. menino, kid: caçoar
kidnap	kidnap: sequestrar, kidnap: seqüestrar
killing	killing: subs. assassinato
kill	kill: matar
kilo	kilo: subs. kilo
kilometer	kilometer: subs. quilómetro, kilometer: subs. quilômetro
kilometre	kilometre: subs. quilómetro
kind	kind: subs. classe, kind: adj.sint. amável
kindly	kindly: adv. amavelmente
kindness	kindness: subs. bondade
kingdom	kingdom: subs. reino
king	king: subs. rei, king: subs. rainha
kiss	kiss: subs. beijo, kiss: dar um beijo
km	km: subs. km
knee	knee: subs. joelho
knife	knife: subs. faca
knit	knit: tecer
knock	knock: subs. golpe, knock: golpear
knot	knot: subs. nodo
know	know: conhecer, know: saber
knowledge	knowledge: subs. conhecimento
korean	Korean: subs. coreano, Korean: adj. coreano
label	label: subs. etiqueta, label: subs. letreiro, label: etiquetar
lab	lab: subs. laboratório
laboratory	laboratory: subs. laboratório
labor	labor: subs. trabalho
labour	labour: subs. trabalho, labour: adj. laboral, labour: adj. trabalhista
lack	lack: subs. carência
lad	lad: subs. garoto, lad: subs. moço
lady	lady: subs. senhor
laicism	laicism: subs. laicismo
lake	lake: subs. lago
lamb	lamb: subs. cordeiro
lamp	lamp: subs. lustre, lamp: subs. luz
land	land: subs. terra, land: aterrizar
landlord	landlord: subs. amo, landlord: subs. dono
landscape	landscape: subs. paisagem
lane	lane: subs. caminho
language	language: subs. idioma, language: subs. língua
large	large: adj.sint. grande
laser	laser: subs. laser
lasting	lasting: adj. duradouro
late	late: adj.sint. tardio, late: adv. tarde
lately	lately: adv. ultimamente
lateral	lateral: adj. lateral
later	later: adv. mais tarde, later: adv. posteriormente
later on	later on: adv. mais tarde
lathe	lathe: subs. turno
latin	Latin: subs. latino, Latin: adj. latino
latter	latter: adj. último
laugh	laugh: subs. riso, laugh: rir
laughter	laughter: subs. riso
launch	launch: subs. lançamento, launch: arrojar, launch: lançar
lawful	lawful: adj. lícito
lawfulness	lawfulness: subs. legalidade
law	law: subs. direito, law: subs. lei
lawn	lawn: subs. grama
lawyer	lawyer: subs. advogado
layer	layer: subs. camada, layer: subs. capa
lay	lay: pôr
leader	leader: subs. dirigente, leader: subs. líder
leadership	leadership: subs. liderança
lead	lead: subs. vantagem, lead: dirigir
leaf	leaf: subs. folha
lean	lean: apoiar
leap	leap: subs. salto, leap: saltar
learning	learning: subs. aprendizagem, learning: subs. saber
learn	learn: aprender
lease	lease: subs. arrendamento, lease: arrendar
least	least: adv. menos
leather	leather: subs. pele
leave	leave: deixar, leave: marchar
lebanese	Lebanese: adj. libanês
lecture	lecture: subs. conferência
left-handed	left-handed: adj. esquerdista
lefthand	lefthand: adj. esquerdo
legalize	legalize: legalizar
legal	legal: adj. legal
legally	legally: adv. legalmente
legend	legend: subs. lenda
legislation	legislation: subs. legislação
legislative	legislative: adj. legislativo
legislator	legislator: subs. legislador
legislature	legislature: subs. legislatura
legitimacy	legitimacy: subs. legitimidade
legitimate	legitimate: adj. legítimo
legitimately	legitimately: adv. legitimamente
leg	leg: subs. perna
lemma	lemma: subs. lema
lend	lend: deixar
length	length: subs. longitude
lengthy	lengthy: adj. longo
lens	lens: subs. lente
lesser	lesser: adj. menor
less	less: adv. menos
lesson	lesson: subs. lição
lethal	lethal: adj. letal
let	let: deixar
letter	letter: subs. carta, letter: subs. letra
leukaemia	leukaemia: subs. leucemia
level	level: subs. nível
liability	liability: subs. responsabilidade
liberalism	liberalism: subs. liberalismo
liberal	liberal: adj. liberal
librarian	librarian: subs. bibliotecário
library	library: subs. biblioteca
licence	licence: subs. licença
license	license: subs. licença
licit	licit: adj. lícito
licking	licking: subs. surra
lid	lid: subs. tampa, lid: subs. pálpebra
lie	lie: subs. mentira
life	life: subs. vida
lift	lift: subs. elevador, lift: subs. impulso
ligament	ligament: subs. atadura
light	light: subs. lustre, light: subs. luz, light: adj.sint. ligeiro, light: adj.sint. claro, light: acender, light: alumiar, light: iluminar
lightly	lightly: adv. ligeiramente
lightweight	lightweight: adj. ligeiro
ligthful	ligthful: adj. luminoso
like	like: agradar, like: gostar, like: pr. como
likely	likely: adj. provável, likely: adv. provavelmente
like this	like this: adv. assim
likewise	likewise: adv. assim mesmo
limitation	limitation: subs. limitação
limit	limit: subs. limite, limit: limitar
line	line: subs. linha
linguistic	linguistic: adj. linguístico, linguistic: adj. lingüístico
link	link: enlaçar
lion	lion: subs. leão
lip	lip: subs. lábio
liquid	liquid: subs. líquido, liquid: adj. líquido
listen	listen: escutar, listen: ouvir
listing	listing: subs. listagem
list	list: subs. lista, list: listar
literally	literally: adv. literalmente
literary	literary: adj. literário
literate	literate: adj. culto
literature	literature: subs. literatura
liter	liter: subs. litro
litre	litre: subs. litro
little	little: adj. pequeno, little: adv. pouco
littoral	littoral: adj. litoral
live	live: morar, live: viver
lively	lively: adj. vivo
llama	llama: subs. lume
load	load: subs. carga, load: subs. ónus
loan	loan: subs. empréstimo, loan: emprestar, loan: prestar
local	local: adj. local
locate	locate: localizar
location	location: subs. localização
logical	logical: adj. lógico
logically	logically: adv. logicamente
logic	logic: subs. lógica
logistical	logistical: adj. logístico
lonely	lonely: adj. solitário
long	long: adj.sint. longo
longshore	longshore: adj. litoral
look for	look for: buscar, look for: procurar
look like	look like: parecer
look	look: subs. aspecto, look: subs. mirada, look: olhar, look: parecer
loom	loom: ameaçar
lord	lord: subs. senhor
lorry	lorry: subs. caminhão
lose	lose: perder
loss	loss: subs. perda
love	love: subs. amor, love: encantar, love: amar, love: estimar
lovely	lovely: adj.sint. precioso
lover	lover: subs. amante
low	low: adj.sint. baixo, low: adv. abaixo
luckily	luckily: adv. felizmente
luck	luck: subs. sorte
lucky	lucky: adj.sint. afortunado
lucre	lucre: subs. lucro
luggage	luggage: subs. bagagem
luminous	luminous: adj. luminoso
lump	lump: subs. pedaço
lunch	lunch: subs. comida, lunch: comer
lung	lung: subs. pulmão
luxury	luxury: subs. luxo
lyric	lyric: n.pl. letra
machine	machine: subs. máquina
machinery	machinery: subs. mecanismo, machinery: subs. maquinaria
mad	mad: adj. louco
mafia	mafia: subs. máfia
magazine	magazine: subs. revista
magician	magician: subs. mago
magic	magic: subs. magia, magic: adj. mágico
magistrate	magistrate: subs. magistrado
magnetic	magnetic: adj. magnético
magnet	magnet: subs. íman
magnificent	magnificent: adj. magnífico
magnitude	magnitude: subs. magnitude
mail	mail: subs. correio
mainly	mainly: adv. notadamente, mainly: adv. principalmente
main	main: adj. maior, main: adj. principal
maintain	maintain: manter
maintenance	maintenance: subs. manutenção
majority	majority: subs. maioria
major	major: adj. importante
make	make: subs. marca, make: fazer
maker	maker: subs. fabricante
male	male: subs. homem
maliciousness	maliciousness: n.sg. maldade
malignant	malignant: adj. maligno
maltreatment	maltreatment: subs. mau-trato
manage	manage: alcançar, manage: atingir, manage: conseguir, manage: dirigir
management	management: subs. administração, management: n.sg. gestão
manager	manager: subs. director, manager: subs. responsável
mandate	mandate: subs. mandato
mandator	mandator: subs. mandatário
manifest	manifest: manifestar
manifesto	manifesto: subs. manifesto
manipulate	manipulate: manipular
manipulation	manipulation: subs. manipulação
mankind	mankind: subs. humanidade
man	man: subs. homem, man: subs. varão
manner	manner: n.sg. maneira, manner: n.pl. maneira, manner: n.pl. modo
manoeuvre	manoeuvre: subs. manobra
mansion	mansion: subs. mansão
mantle	mantle: subs. manto
manufacture	manufacture: subs. fabricação, manufacture: fabricar
manufacturer	manufacturer: subs. fabricante
manufacturing	manufacturing: subs. fabricação
manuscript	manuscript: subs. manuscrito
map	map: subs. mapa
marathon	marathon: subs. maratona
march	March: subs. março, march: subs. andamento, march: subs. marcha, march: subs. passeata
marginal	marginal: adj. insignificante
margin	margin: subs. margem
marine	marine: adj. marinho
maritime	maritime: adj. marítimo
marketing	marketing: subs. marketing
market	market: subs. mercado
mark	mark: subs. marca, mark: marcar, mark: manchar
marriage	marriage: subs. casal
martyrdom	martyrdom: subs. martírio
marvellous	marvellous: adj. maravilhoso
marxist	Marxist: adj. marxista
masculine	masculine: adj. masculino
mask	mask: subs. máscara
massively	massively: adv. em massa
massive	massive: adj. em massa
mass	mass: subs. massa, mass: concentrar, mass: subs. massa
master	master: subs. patrão, master: n.sg. maestro, master: n.sg. maestro, master: n.sg. maestro, master: n.sg. maestro, master: n.sg. maestro, master: n.pl. maestro, master: n.pl. maestro, master: n.pl. maestro, master: n.pl. maestro, master: n.pl. maestro
match	match: subs. partido
mate	mate: subs. colega
material	material: subs. material, material: adj. material
mathematical	mathematical: adj. matemático
matter	matter: subs. assunto, matter: subs. matéria, matter: importar, matter: subs. matéria
mature	mature: adj. maduro, mature: adj. maturo, mature: madurar
maturity	maturity: subs. maturidade
maximal	maximal: adj. máximo
maximum	maximum: adj. máximo
maybe	maybe: adv. quiçá
may	May: subs. maio
mayor	mayor: subs. prefeito
meadow	meadow: subs. prado
meaningful	meaningful: adj. significativo
mean	mean: adj.sint. mau, mean: significar
means	means: subs. meio
measure	measure: subs. medida, measure: medir
measurement	measurement: subs. medida
meat	meat: subs. carne
mechanical	mechanical: adj. mecânico
mechanism	mechanism: subs. mecanismo
medal	medal: subs. medalha
mediation	mediation: subs. mediação
medical	medical: adj. médico
medicine	medicine: subs. medicina, medicine: subs. medicamento
meeting	meeting: subs. reunião, meeting: subs. encontro
meet	meet: cumprir, meet: conhecer, meet: combinar com
melancholic	melancholic: adj. melancólico
melange	melange: subs. mistura
mellow	mellow: adj. doce
melt	melt: fundir
member	member: subs. membro
memory	memory: subs. memória
mentality	mentality: subs. mentalidade
mentally	mentally: adv. mentalmente
mental	mental: adj. mental
mention	mention: mencionar
menu	menu: subs. carta
mercantile	mercantile: adj. mercantil
mercy	mercy: subs. piedade
merely	merely: adv. meramente
mere	mere: adj. mero
merger	merger: subs. fusão
merit	merit: subs. mérito
message	message: subs. mensagem
messenger	messenger: subs. mensageiro
metallic	metallic: adj. metálico
metal	metal: subs. metal
metaphor	metaphor: subs. metáfora
method	method: subs. método
metre	metre: subs. metro, metre: subs. metrô
metropolitan	metropolitan: adj. metropolitano
mexican	Mexican: adj. mexicano
microphone	microphone: subs. microfone
midday	midday: subs. meio dia
midnight	midnight: subs. meia-noite
migrant	migrant: adj. emigrante
migrate	migrate: emigrar
mild	mild: adj.sint. suave
mile	mile: subs. milha
milestone	milestone: subs. meta
militant	militant: subs. militante
military	military: adj. militar
milk	milk: subs. leite
millennium	millennium: subs. milénio, millennium: subs. milênio
millionaire	millionaire: subs. milionário
million	million: subs. milhão
mind	mind: subs. mente, mind: importar
mine	mine: subs. mina, mine: adj. meu, mine: prn.pos.mf.sp. o meu, mine: prn.pos. o meu
miner	miner: subs. mineiro
minimal	minimal: adj. mínimo
minimum	minimum: adj. mínimo
ministerial	ministerial: adj. ministerial
minister	minister: n.sg. ministro, minister: n.sg. ministro, minister: n.sg. ministro, minister: n.sg. ministro, minister: n.sg. ministro, minister: n.pl. ministro, minister: n.pl. ministro, minister: n.pl. ministro, minister: n.pl. ministro, minister: n.pl. ministro
ministry	ministry: subs. ministério
minoritary	minoritary: adj. minoritário
minor	minor: subs. menor, minor: adj. menor
minute	minute: subs. minuto
miracle	miracle: subs. milagre
mirror	mirror: subs. espelho
miserable	miserable: adj. azarado, miserable: adj. coitado, miserable: adj. desgraçado
misfortune	misfortune: subs. desgraça
mission	mission: subs. missão
miss	miss: perder
misuse	misuse: subs. abuso
mixed	mixed: adj. misto
mix	mix: subs. mistura, mix: misturar
mobile	mobile: adj. móvel
mobilization	mobilization: subs. mobilização
modal	modal: adj. modal
model	model: subs. modelo
mode	mode: subs. modo, mode: subs. moda
moderate	moderate: moderar
modernization	modernization: subs. modernização
modern	modern: adj. moderno
modest	modest: adj. modesto
modification	modification: subs. modificação
modify	modify: modificar
module	module: subs. módulo
molecule	molecule: subs. molécula
moment	moment: subs. momento
monarch	monarch: subs. monarca
monday	Monday: subs. segunda-feira, Monday: n.ND. segunda-feira, Monday: n.ND. segunda-feira
monetary	monetary: adj. monetário
monitoring	monitoring: subs. controle
monitor	monitor: controlar
monk	monk: subs. monge
monopoly	monopoly: subs. monopólio
monster	monster: subs. monstro
monthly	monthly: adj. mensal
month	month: subs. mês
monumentally	monumentally: adv. extremamente
monument	monument: subs. monumento
mood	mood: subs. humor, mood: subs. modo
moon	moon: subs. lua
morally	morally: adv. moralmente
moral	moral: adj. moral
more	more: adv. mais
moreover	moreover: adv. ademais
morning	morning: subs. manhã, morning: subs. madrugada
moroccan	Moroccan: adj. marroquino
mortality	mortality: subs. mortalidade
mortal	mortal: adj. mortal
mortar	mortar: subs. morteiro
mosquito	mosquito: subs. mosquito
mostly	mostly: adv. maioritariamente
most	most: adv. mais
motherhood	motherhood: subs. maternidade
mother	mother: subs. mãe
motionless	motionless: adj. imóvel
motion	motion: subs. moção, motion: subs. movimento
motivate	motivate: motivar
motivation	motivation: subs. motivação
motorbike	motorbike: subs. mota, motorbike: subs. moto
motor	motor: subs. motor
mountain	mountain: subs. montanha, mountain: subs. monte
mount	mount: subs. monte, mount: montar
mouse	mouse: subs. rato
mouth	mouth: subs. boca, mouth: subs. desembocadura
movement	movement: subs. movimento
move	move: subs. movimento, move: mover, move: movimentar, move: transladar, move: trasladar
movie	movie: subs. filme, movie: subs. película
much longer	much longer: adv. bem mais
much more	much more: adv. bem mais
much	much: adv. muito
mulch	mulch: subs. leito
multinational	multinational: subs. multinacional
multiply	multiply: multiplicar
municipality	municipality: subs. concelho, municipality: subs. município
municipal	municipal: adj. municipal
murderer	murderer: subs. assassino
murder	murder: subs. assassinato
muscle	muscle: subs. músculo
museum	museum: subs. museu
musical	musical: adj. musical
musician	musician: subs. músico
muslim	Muslim: adj. muçulmano
mutter	mutter: murmurar
mutual	mutual: adj. mútuo
my	my: det.pos.sp. o meu, my: det. meu, my: det. o meu
mysterious	mysterious: adj. misterioso
mystery	mystery: subs. mistério
mythical	mythical: adj. mítico
myth	myth: subs. mito
nail	nail: subs. chave, nail: subs. cravo, nail: subs. unha
naïve	naïve: adj.sint. ingénuo, naïve: adj.sint. ingênuo
namely	namely: adv. isto é
name	name: subs. nome, name: denominar
nape	nape: subs. nuca
narrative	narrative: adj. narrativo
narrow	narrow: adj.sint. estreito
nasty	nasty: adj.sint. mau
natal	natal: adj. natal
nationalism	nationalism: subs. nacionalismo
nationality	nationality: subs. nacionalidade
national	national: adj. nacional
nation	nation: subs. nação
native	native: adj. indígena
naturally	naturally: adv. naturalmente
natural	natural: adj. natural
nature	nature: subs. natureza
naval	naval: adj. naval
nave	nave: subs. nave
navigation	navigation: subs. navegação
nazism	Nazism: subs. nazismo
nearby	nearby: adj. próximo
near here	near here: adv. perto
near	near: adj.sint. próximo, near: pr. cerca de, near: adv. perto
necessarily	necessarily: adv. necessariamente
necessary	necessary: adj. necessário
neck	neck: subs. colarinho, neck: subs. pescoço
needle	needle: subs. agulha
need	need: subs. necessidade, need: precisar
negative	negative: adj. negativo
negotiate	negotiate: negociar
negotiation	negotiation: n.pl. gestão, negotiation: subs. negociação
neighbourhood	neighbourhood: subs. bairro
neighbouring	neighbouring: adj. vizinho
neighbour	neighbour: subs. vizinho
neither	neither: cnjcoo. nem, neither: adv. também não, neither: adv. tampouco
nephew	nephew: subs. sobrinho
nerve	nerve: subs. nervo
nervous	nervous: adj. nervoso
nest	nest: subs. ninho
net	net: subs. rede, net: adj.sint. limpo
network	network: subs. rede
neuron	neuron: subs. neurónio, neuron: subs. neurônio
neutralize	neutralize: neutralizar
never	never: adv. jamais, never: adv. nunca
newly	newly: adv. novamente
new	new: adj.sint. novo
news	news: subs. notícia
newspaper	newspaper: subs. jornal
next	next: adj. próximo
nicely	nicely: adv. amavelmente
nickname	nickname: subs. renome
niece	niece: subs. sobrinho
nigerian	Nigerian: adj. nigeriano
nightingale	nightingale: subs. rouxinol
nightmare	nightmare: subs. pesadelo
night	night: subs. noite
nineteen	nineteen: num. dezanove, nineteen: num. dezenove
nobility	nobility: subs. nobreza
noble	noble: adj.sint. nobre
nobody	nobody: prsubs. ninguém
nocturnal	nocturnal: adj. nocturno, nocturnal: adj. noturno
noise	noise: subs. ruído
nominate	nominate: nomear
nomination	nomination: subs. nomeação
none	none: prn.tn.nt. nenhum
non	non: adv. não
no	no: det.ind. nenhum, no: adv. não
no one	no one: prsubs. ninguém
noon	noon: subs. meio dia
noose	noose: subs. laço
normality	normality: subs. normalidade
normalization	normalization: subs. normalização
normally	normally: adv. normalmente
normal	normal: adj. normal
normative	normative: adj. normativo
norm	norm: subs. norma
nor	nor: cnjcoo. nem
north	north: subs. norte
northwest	northwest: subs. noroeste
nose	nose: subs. nariz
nostalgia	nostalgia: subs. nostalgia
notable	notable: adj. notável
notably	notably: adv. notavelmente
notary	notary: subs. notário
note	note: subs. bilhete, note: subs. nota, note: anotar
nothing	nothing: prsubs. nada
noticeably	noticeably: adv. sensivelmente
notice	notice: subs. anúncio
notion	notion: subs. ideia
not	not: adv. não
nourish	nourish: nutrir
novel	novel: subs. novela, novel: subs. romance
novelty	novelty: subs. novidade
november	November: subs. novembro
now	now: adv. agora
nuance	nuance: subs. matiz
nuclear	nuclear: adj. nuclear
nucleus	nucleus: subs. núcleo
number	number: subs. número
numerous	numerous: adj. numeroso
nurse	nurse: subs. enfermeiro
obedience	obedience: subs. obediência
obey	obey: obedecer
objective	objective: subs. objectivo, objective: adj. objectivo, objective: adj. objetivo
object	object: subs. objecto, object: subs. objeto, object: subs. objectivo
obligation	obligation: subs. obrigação
obscure	obscure: adj. escuro
observation	observation: subs. observação
observe	observe: observar
observer	observer: subs. observador
obstacle	obstacle: subs. obstáculo
obstinacy	obstinacy: subs. obstinação
obtain	obtain: obter
obviously	obviously: adv. evidentemente, obviously: adv. obviamente
obvious	obvious: adj. óbvio
occasionally	occasionally: adv. ocasionalmente
occasional	occasional: adj. ocasional
occasion	occasion: subs. ocasião
occidental	occidental: adj. ocidental
occident	occident: subs. ocidente
occupant	occupant: subs. ocupante
occupational	occupational: adj. laboral, occupational: adj. trabalhista
occupation	occupation: subs. emprego, occupation: subs. ocupação
occupy	occupy: desempenhar, occupy: ocupar
occur	occur: ocorrer
ocean	ocean: subs. oceano
october	October: subs. outubro
octopus	octopus: n.sg. pop, octopus: n.pl. pop
odd	odd: adj.sint. estranho
of course	of course: adv. naturalmente
offence	offence: subs. ofensa, offence: subs. delito
offend	offend: ofender
offensive	offensive: adj. ofensivo
offer	offer: subs. oferta, offer: oferecer
office	office: subs. escritório
officer	officer: subs. agente
officially	officially: adv. oficialmente
official	official: subs. oficial, official: adj. oficial
off	off: pr. de, off: adv. fora
of like mind	of like mind: adv. conforme
of note	of note: adj. importante
of	of: pr. de
often	often: adv. com freqüência
oh	oh: ij. oh
oil	oil: subs. azeite, oil: subs. óleo, oil: subs. petróleo
old-fashioned	old-fashioned: adj. antiquado
old	old: adj.sint. velho
olympic	olympic: adj. olímpico
on a day-to-day basis	on a day-to-day basis: adv. diariamente
on a long-term basis	on a long-term basis: adv. em longo prazo
on an individual basis	on an individual basis: adv. individualmente
on a short-term basis	on a short-term basis: adv. em curto prazo
on a small scale	on a small scale: adv. em curto prazo
one	one: prn.tn.mf. um
ongoing	ongoing: adj. actual
on impulse	on impulse: adv. de repente
only	only: adj. sozinho, only: adj. único, only: adv. somente, only: adv. unicamente, only: adv. apenas, only: adv. só
on	on: pr. em, on: pr. a respeito de, on: pr. sobre, on: adv. cima, on: adv. em cima
on purpose	on purpose: adv. expressamente, on purpose: adv. nomeadamente
on record	on record: adv. oficialmente
on the average	on the average: adv. em media
on the doble	on the doble: adv. rapidamente
on time	on time: adv. pontualmente
onto	onto: pr. a
on top of	on top of: pr. sobre
on top	on top: adv. acima
opaque	opaque: adj. opaco
opening	opening: subs. abertura
openly	openly: adv. abertamente
open	open: começar, open: abrir
opera	opera: subs. ópera
operate	operate: operar, operate: manejar, operate: funcionar
operating	operating: adj. operativo
operation	operation: subs. funcionamento, operation: subs. operação
operative	operative: adj. operativo
operator	operator: subs. operador
opinion	opinion: subs. opinião
opponent	opponent: subs. adversário
opportunity	opportunity: subs. chance, opportunity: subs. oportunidade
opposition	opposition: subs. oposição
optimism	optimism: subs. optimismo, optimism: subs. otimismo
optimistic	optimistic: adj. optimista, optimistic: adj. otimista
optimize	optimize: optimizar, optimize: otimizar
optimum	optimum: adj. óptimo, optimum: adj. ótimo
option	option: subs. opção
opt	opt: optar
orbit	orbit: subs. órbita
order	order: subs. ordem, order: ordenar
ordinarily	ordinarily: adv. normalmente
ordinary	ordinary: adj. normal
organic	organic: adj. orgânico
organisation	organisation: subs. organização
organise	organise: organizar
organism	organism: subs. organismo
organization	organization: subs. organização
organize	organize: organizar
organizer	organizer: subs. organizador
organ	organ: subs. órgão
oriel	oriel: subs. olhador
oriental	oriental: adj. oriental
orientation	orientation: subs. orientação
original	original: adj. original
originate	originate: originar
origin	origin: subs. origem
or	or: cnjcoo. nem, or: cnjcoo. ou
osseous	osseous: adj. ósseo
other	other: det.ind.pl. outro, other: det.ind.pl. outro, other: det.ind.sp. outro, other: det.ind.sp. outro, other: det.ind.sp. outro, other: det. outro, other: det. outro, other: det. restantes
others	others: prn.tn.mf.pl. outro
our	our: det.pos.sp. o nosso, our: det. nosso, our: det. o nosso
ours	ours: adj. nosso, ours: prn.pos.mf.sp. o nosso, ours: prn.pos. o nosso
outcome	outcome: subs. resultado
outdoor	outdoor: adj. exterior
outer	outer: adj. exterior
outline	outline: subs. esquema
out of the blue	out of the blue: adv. de repente
out	out: adv. afora, out: adv. fora
output	output: subs. produção, output: subs. saída
outright	outright: adv. francamente
outside	outside: subs. exterior, outside: adj. exterior, outside: adv. afora, outside: adv. fora
outstanding	outstanding: adj. excepcional
out there	out there: adv. ali
oven	oven: subs. estufa, oven: subs. forno
overcome	overcome: vencer
overhead	overhead: adj. elevado
over	over: pr. durante, over: pr. sobre
overriding	overriding: adj. primordial
over there	over there: adv. ali
owe	owe: dever
owner	owner: subs. dono, owner: subs. proprietário
ownership	ownership: subs. propriedade
own	own: adj. próprio, own: possuir
oxygen	oxygen: subs. oxigénio, oxygen: subs. oxigênio
ozone	ozone: subs. ozónio, ozone: subs. ozônio
pace	pace: subs. ritmo, pace: subs. passo
package	package: subs. pacote
packet	packet: subs. pacote
pack	pack: subs. pacote, pack: subs. grupo, pack: envolver
pact	pact: subs. pacto
page	page: subs. página
painful	painful: adj. doloroso
pain	pain: subs. dor
painter	painter: subs. pintor
painting	painting: subs. pintura
paint	paint: subs. pintura, paint: pintar
pair	pair: subs. par
palace	palace: subs. palácio
pale	pale: adj. pálido
palestinian	Palestinian: subs. palestiniano, Palestinian: subs. palestino, Palestinian: adj. palestiniano, Palestinian: adj. palestino
panel	panel: subs. tabuleiro
panic	panic: subs. pânico
panorama	panorama: subs. panorama
panther	panther: subs. pantera
paper	paper: subs. artigo, paper: subs. papel
parade	parade: desfilar
paradoxically	paradoxically: adv. paradoxalmente
paragraph	paragraph: subs. parágrafo
paraguayan	Paraguayan: adj. paraguaio
parallel	parallel: adj. paralelo
paralyze	paralyze: paralisar
pardon	pardon: subs. perdão
parent	parent: subs. pai, parent: n.pl. padre, parent: n.pl. pai
parity	parity: subs. paridade
parking	parking: subs. estacionamento
park	park: subs. parque, park: estacionar
parliamentary	parliamentary: adj. parlamentar
parliament	parliament: subs. parlamento
partially	partially: adv. parcialmente
partial	partial: adj. parcial
participant	participant: subs. participante
participate	participate: participar
participation	participation: subs. participação
particle	particle: subs. partícula
particularly	particularly: adv. particularmente
particular	particular: adj. particular
partner	partner: subs. colega, partner: subs. companheiro, partner: subs. sócio
partnership	partnership: subs. sociedade
part	part: subs. parte, part: separar
party	party: subs. festa, party: subs. partido
passage	passage: subs. passo, passage: subs. bilhete, passage: subs. passagem
passing	passing: subs. morte, passing: subs. passo
passion	passion: subs. paixão
pass	pass: aprovar, pass: passar
passport	passport: subs. passaporte
past	past: subs. passado, past: adj. passado
path	path: subs. trajectória, path: subs. trajetória, path: subs. caminho
patience	patience: subs. paciência
patiently	patiently: adv. pacientemente
patient	patient: subs. paciente, patient: adj. paciente
patriarch	patriarch: subs. patriarca
patrol	patrol: subs. patrulha
pattern	pattern: subs. patrão
pause	pause: subs. pausa, pause: parar
payment	payment: subs. pagamento
pay	pay: pagar
peaceful	peaceful: adj. pacífico
peace	peace: subs. paz
peak	peak: subs. cima, peak: subs. cimeira, peak: subs. cimo, peak: subs. cume
peasant	peasant: subs. camponês
peculiar	peculiar: adj. estranho
peel	peel: pelar
penal	penal: adj. penal
penalty	penalty: subs. pena
penance	penance: subs. penitência
penetrate	penetrate: penetrar
peninsula	peninsula: subs. península
pension	pension: subs. pensão
perceive	perceive: perceber
percentage	percentage: subs. percentagem
percent	percent: subs. percentagem
percussion	percussion: subs. percussão
perfectly	perfectly: adv. perfeitamente
perfect	perfect: adj. perfeito
performance	performance: subs. actuação, performance: subs. atuação, performance: subs. auto, performance: subs. rendimento, performance: subs. interpretação
performer	performer: subs. intérprete
perform	perform: actuar
perfume	perfume: subs. perfume
perhaps	perhaps: adv. quiçá
periodic	periodic: adj. periódico
period	period: subs. época, period: subs. período
periphery	periphery: subs. periferia
permanence	permanence: subs. permanência
permanently	permanently: adv. permanentemente
permanent	permanent: adj. permanente
permission	permission: subs. permissão
permit	permit: subs. permissão, permit: permitir
per	per: pr. por
perpetual	perpetual: adj. perpétuo
persecution	persecution: subs. perseguição
persist	persist: persistir
personality	personality: subs. personalidade
personal	personal: adj. pessoal
personnel	personnel: n.pl. pessoal
person	person: n.pl. gente, person: subs. pessoa
perspective	perspective: subs. perspectiva
pertinent	pertinent: adj. procedente
perturb	perturb: perturbar
peruvian	Peruvian: adj. peruano
perverse	perverse: adj. perverso
peseta	peseta: subs. peseta
petrol	petrol: subs. gasolina
pharmacy	pharmacy: subs. farmácia
phase	phase: subs. fase
phenomenon	phenomenon: subs. fenómeno, phenomenon: subs. fenômeno
phone	phone: subs. telefone
photographer	photographer: subs. fotógrafo
photograph	photograph: fotografar
photo	photo: subs. foto
phrase	phrase: subs. frase
physically	physically: adv. fisicamente
physical	physical: adj. físico
piano	piano: subs. piano
pick	pick: recolher, pick: eleger
pick up	pick up: sep. pegar
picture	picture: subs. quadro
piece	piece: subs. peça, piece: subs. pedaço
pigeon	pigeon: subs. pombo
pig	pig: subs. porco
pilgrim	pilgrim: subs. peregrino
pilot	pilot: subs. piloto, pilot: pilotar
pink	pink: subs. rosa, pink: adj.sint. rosa
pin	pin: cravar, pin: fincar
pioneer	pioneer: iniciar
pipe	pipe: subs. conduto
pitch	pitch: subs. tom
pittance	pittance: subs. miséria
pity	pity: n.sg. lástima, pity: subs. pena, pity: subs. lástima
place	place: subs. lugar, place: subs. posto, place: colocar
placing	placing: subs. colocação
plain	plain: subs. planície, plain: adj.sint. singelo
plane	plane: subs. avião, plane: subs. plano
planet	planet: subs. planeta
planing	planing: subs. planejamento
planning	planning: subs. planeamento, planning: subs. planejamento
plan	plan: subs. plano, plan: planear
plant	plant: subs. planta, plant: plantar
plastic	plastic: subs. plástico
plate	plate: subs. ferro, plate: subs. placa
platform	platform: subs. plataforma
player	player: subs. intérprete, player: subs. jogador
playground	playground: subs. pátio, playground: subs. quintal
play	play: subs. jogo, play: jogar, play: tocar, play: interpretar, play: reproduzir
pleasant	pleasant: adj. agradável
please	please: comprazer
pleasure	pleasure: subs. prazer
plenty	plenty: subs. abundância
plough	plough: arar, plough: lavrar
plug	plug: subs. tampa
plural	plural: subs. plural, plural: adj. plural
pneumatic	pneumatic: adj. pneumático
pneumonia	pneumonia: subs. pneumonia
poem	poem: subs. poema
poetic	poetic: adj. poético
poet	poet: subs. poeta, poet: subs. poeta, poet: subs. poeta
poetry	poetry: subs. poesia
point	point: subs. ponto, point: assinalar, point: apontar
poison	poison: subs. veneno
pole	pole: subs. pólo, pole: subs. pau
policeman	policeman: subs. policial, policeman: subs. polícia, policeman: subs. guarda
police	police: n.pl. policial, police: n.pl. polícia, police: adj. policial
policewoman	policewoman: subs. polícia
politically	politically: adv. politicamente
political	political: adj. político
politician	politician: subs. político
pollute	pollute: contaminar
pollution	pollution: subs. contaminação
pomegranate	pomegranate: subs. granada
pool	pool: subs. grupo
poor	poor: adj.sint. pobre
pope	pope: subs. papa
pop	pop: n.sg. pop
popularity	popularity: subs. popularidade
popular	popular: adj. popular
populate	populate: povoar
population	population: subs. população
pork	pork: subs. porco
portal	portal: subs. portal
portfolio	portfolio: subs. pasta
port	port: subs. porto
portuguese	Portuguese: adj. português
pose	pose: propor
position	position: subs. posição, position: colocar
positively	positively: adv. positivamente
positive	positive: adj. positivo
possession	possession: subs. posse
possess	possess: possuir
possibility	possibility: subs. possibilidade
possible	possible: adj. possível
possibly	possibly: adv. porventura, possibly: adv. possivelmente
posterior	posterior: adj. posterior
poster	poster: subs. cartaz, poster: subs. cartel
postman	postman: subs. carteiro
postpone	postpone: adiar
post	post: subs. correio, post: subs. cargo, post: subs. pau
posture	posture: subs. postura
potentially	potentially: adv. potencialmente
pot	pot: subs. teste
pour	pour: verter
poverty	poverty: subs. pobreza
powerfully	powerfully: adv. poderosamente
powerful	powerful: adj. potente, powerful: adj. poderoso
powerless	powerless: adj. impotente
power	power: subs. energia, power: subs. poder
practically	practically: adv. praticamente
practical	practical: adj. prático
practice	practice: subs. prática, practice: praticar
practise	practise: praticar
practitioner	practitioner: subs. praticante
praise	praise: subs. elogio, praise: alabar
prayer	prayer: subs. oração
pray	pray: rogar
preach	preach: pregar
precarious	precarious: adj. precário
precedent	precedent: subs. precedente
precede	precede: preceder
precious	precious: adj. precioso
precipitate	precipitate: precipitar
precipitation	precipitation: subs. precipitação
precisely	precisely: adv. justamente, precisely: adv. certeiramente, precisely: adv. precisamente
precise	precise: adj. preciso
preclude	preclude: impedir
predictable	predictable: adj. previsível
prediction	prediction: subs. predição
preferable	preferable: adj. preferível
preference	preference: subs. preferência
prefer	prefer: preferir
pregnancy	pregnancy: subs. gravidez
prejudice	prejudice: subs. preconceito, prejudice: prejudicar
preliminary	preliminary: adj. preliminar
première	première: subs. estréia
preparation	preparation: subs. preparação
prepare	prepare: preparar
prescribe	prescribe: prescrever
presence	presence: subs. presença
presentation	presentation: subs. apresentação
present	present: subs. presente, present: adj. presente, present: apresentar
preservative	preservative: subs. conservante
preserve	preserve: preservar
presidency	presidency: subs. presidência
presidential	presidential: adj. presidencial
president	president: subs. presidente
press	press: subs. imprensa, press: pulsar
pressure	pressure: subs. pressão
prestige	prestige: subs. prestígio
presumably	presumably: adv. provavelmente
presumption	presumption: subs. presunção
presumptive	presumptive: adj. suposto
pretence	pretence: subs. pretensão
pretend	pretend: pretender, pretend: visar
pretext	pretext: subs. pretexto
pretty	pretty: adj. bonito
prevail	prevail: prevalecer, prevail: primar
prevention	prevention: subs. prevenção
preventive	preventive: adj. preventivo
prevent	prevent: evitar
previously	previously: adv. previamente, previously: adv. anteriormente
previous	previous: adj. prévio, previous: adj. anterior, previous: adj. precedente
price	price: subs. preço, price: subs. tarifa
pride	pride: subs. orgulho
priest	priest: subs. sacerdote
primarily	primarily: adv. principalmente
primitive	primitive: adj. primitivo
prince	prince: subs. príncipe
princess	princess: subs. príncipe
principally	principally: adv. principalmente
principal	principal: adj. principal, principal: adj. capital
principle	principle: subs. princípio
printing	printing: subs. impressão
priority	priority: subs. prioridade
prior	prior: adj. prévio
prisoner	prisoner: subs. prisioneiro, prisoner: subs. preso
prison	prison: subs. cárcere, prison: subs. prisão
private	private: adj. privado
privatization	privatization: subs. privatização
privilege	privilege: subs. privilégio
prize	prize: subs. prémio
probability	probability: subs. probabilidade
probable	probable: adj. provável
probably	probably: adv. provavelmente
probe	probe: subs. sonda
problem	problem: subs. problema
procedure	procedure: subs. procedimento
proceed	proceed: proceder, proceed: ir
procession	procession: subs. procissão
process	process: subs. processo
proclaim	proclaim: proclamar
procreation	procreation: subs. procriação
prodigy	prodigy: subs. prodígio
produce	produce: subs. produto, produce: produzir
producer	producer: subs. produtor
production	production: subs. produção
product	product: subs. produto
professionally	professionally: adv. profissionalmente
professional	professional: subs. profissional, professional: adj. profissional
profession	profession: subs. profissão
professor	professor: subs. professor
profile	profile: subs. perfil
profit	profit: subs. benefício
profoundly	profoundly: adv. profundamente
profound	profound: adj. profundo
prognosis	prognosis: subs. prognóstico
programme	programme: subs. programa
programming	programming: subs. programação
program	program: subs. programa
progression	progression: subs. progressão
progressively	progressively: adv. progressivamente
progressive	progressive: adj. progressivo
progress	progress: subs. progresso, progress: progredir
prohibition	prohibition: subs. proibição
projection	projection: subs. projecção, projection: subs. projeção
project	project: subs. projecto, project: subs. projeto, project: projetar, project: projectar, project: tencionar
promenade	promenade: subs. passeio
promise	promise: subs. promessa, promise: prometer
promote	promote: promover
promoter	promoter: subs. promotor
promotion	promotion: subs. promoção, promotion: subs. ascensão
prompt	prompt: adj.sint. pontual, prompt: incitar, prompt: apontar, prompt: assomar
pronounce	pronounce: pronunciar
proof	proof: subs. teste, proof: subs. prova
propaganda	propaganda: subs. propaganda
propagate	propagate: propagar
properly	properly: adv. correctamente, properly: adv. corretamente, properly: adv. adequadamente, properly: adv. devidamente
proper	proper: adj. próprio
property	property: subs. propriedade
prophet	prophet: subs. profeta
proportion	proportion: subs. proporção
proposal	proposal: subs. proposta
propose	propose: propor
proposition	proposition: subs. proposição
prospective	prospective: adj. provável
prospect	prospect: subs. perspectiva
prosperity	prosperity: subs. prosperidade
prostitute	prostitute: subs. prostituta
prostitution	prostitution: subs. prostituição
protagonist	protagonist: subs. protagonista
protection	protection: subs. protecção, protection: subs. proteção
protective	protective: adj. protector, protective: adj. protetor
protect	protect: proteger, protect: respaldar
protein	protein: subs. proteína
protestant	Protestant: subs. protestante
protest	protest: subs. protesto, protest: protestar
protocol	protocol: subs. protocolo
proud	proud: adj.sint. orgulhoso
prove	prove: provar
provided	provided: cnjadv. se
provide	provide: proporcionar
provider	provider: subs. provedor
province	province: subs. provincia
provincial	provincial: adj. provincial
provisionally	provisionally: adv. provisionalmente
provisional	provisional: adj. provisório
provision	provision: n.sg. prestação, provision: subs. provisão
provocation	provocation: subs. provocação
provoke	provoke: provocar
prowess	prowess: subs. coragem
prpers	prpers: prn.obj.p3.nt.sg. o, prpers: prn.obj.p3.nt.sg. o, prpers: prn.obj.p1.mf.sg. mim
prudence	prudence: subs. prudência
psychologically	psychologically: adv. psicologicamente
psychological	psychological: adj. psicológico
psychologist	psychologist: subs. psicólogo
publication	publication: subs. publicação
publicity	publicity: subs. publicidade
publicly	publicly: adv. publicamente
public	public: subs. público, public: adj. público
publisher	publisher: subs. editor
publish	publish: publicar
pull out	pull out: sep. sacar
pull	pull: subs. atração, pull: esticar, pull: puxar
pulse	pulse: subs. pó
pump	pump: subs. bomba
punctual	punctual: adj. pontual
punishment	punishment: subs. castigo, punishment: subs. sanção
punish	punish: castigar
pupil	pupil: n.sg. aluno, pupil: n.sg. aluno, pupil: n.sg. aluno, pupil: n.sg. aluno, pupil: n.sg. aluno, pupil: n.pl. aluno, pupil: n.pl. aluno, pupil: n.pl. aluno, pupil: n.pl. aluno, pupil: n.pl. aluno
puppet	puppet: subs. fantoche
purchase	purchase: adquirir
purchaser	purchaser: subs. comprador
purely	purely: adv. puramente
pure	pure: adj.sint. puro
purportedly	purportedly: adv. pretensamente, purportedly: adv. supostamente
purposely	purposely: adv. expressamente
purpose	purpose: subs. propósito
pursue	pursue: perseguir
pursuit	pursuit: subs. busca, pursuit: subs. perseguição
push	push: subs. empurrão, push: empurrar, push: pulsar
put	put: posar, put: pôr
qualification	qualification: subs. competência, qualification: subs. qualificação, qualification: subs. capacidade
quality	quality: subs. qualidade
quantity	quantity: subs. quantidade
quarterly	quarterly: adj. trimestral
quarter	quarter: subs. bairro, quarter: subs. trimestre
queen	queen: subs. rei, queen: subs. rainha
query	query: subs. consulta
question	question: subs. pergunta, question: subs. questão, question: subs. qüestão, question: questionar
quickly	quickly: adv. rapidamente, quickly: adv. depressa
quick	quick: adj.sint. rápido, quick: adv. rapidamente
quietly	quietly: adv. abaixo
quiet	quiet: adj.sint. calmo
quite a lot	quite a lot: adv. bastante
quotation	quotation: subs. menção
quote	quote: citar
rabbit	rabbit: subs. coelho
rabies	rabies: subs. raiva
race	race: subs. carreira, race: correr, race: acelerar
racial	racial: adj. racial
racing	racing: subs. carreira
racism	racism: subs. racismo
racist	racist: adj. racista
radar	radar: subs. radar
radically	radically: adv. radicalmente
radical	radical: adj. radical
radio	radio: subs. rádio, radio: subs. rádio
rage	rage: subs. raiva, rage: subs. arrebato
raging	raging: adj. furioso
rail	rail: subs. barra
railway	railway: subs. via
rain	rain: subs. chuva
raise	raise: levantar, raise: aumentar, raise: obter, raise: criar
rampart	rampart: subs. muralha
range	range: subs. alcance, range: abarcar
rank	rank: subs. bicha, rank: subs. posição
rape	rape: subs. violação
rapidity	rapidity: subs. rapidez
rapidly	rapidly: adv. rapidamente
rapid	rapid: adj. rápido
rare	rare: adj.sint. raro
rate	rate: subs. índice, rate: subs. ritmo, rate: subs. tarifa, rate: valorizar
rather	rather: adv. bastante
rating	rating: subs. índice
ratio	ratio: subs. proporção
ravine	ravine: subs. barranco
ray	ray: subs. raio
reach for	reach for: pegar
reach	reach: conseguir
reaction	reaction: subs. reacção, reaction: subs. reação
react	react: reagir
reader	reader: subs. leitor
reading	reading: subs. leitura
read	read: ler
real estate	real estate: subs. imobiliária
realise	realise: realizar
realism	realism: subs. realismo
reality	reality: subs. realidade
realization	realization: subs. realização
realize	realize: realizar
really	really: adv. realmente
real	real: adj. real
reasonable	reasonable: adj. razoável
reasonably	reasonably: adv. razoavelmente
reason	reason: subs. motivo, reason: subs. razão
reassure	reassure: tranquilizar, reassure: tranqüilizar
rebellious	rebellious: adj. rebelde
rebel	rebel: subs. rebelde
receipt	receipt: subs. recepção
receive	receive: acolher, receive: sediar, receive: receber
recently	recently: adv. recentemente
recent	recent: adj. recente
reception	reception: subs. recepção
receptor	receptor: subs. receptor
recession	recession: subs. recessão
reckon	reckon: considerar, reckon: calcular
recognition	recognition: subs. reconhecimento
recognize	recognize: reconhecer
recommendation	recommendation: subs. recomendação
recommend	recommend: recomendar
reconstruction	reconstruction: subs. reconstrução
recording	recording: subs. gravação, recording: subs. registro
record	record: subs. recorde, record: subs. récord, record: subs. registro, record: gravar
recover	recover: recuperar
recovery	recovery: subs. recuperação
rector	rector: subs. reitor
recuperate	recuperate: recuperar
red	red: adj. vermelho
reduce	reduce: reduzir
reduction	reduction: subs. redução
reelection	reelection: subs. reeleição
referee	referee: subs. árbitro
reference	reference: subs. referência
referendum	referendum: subs. referendo, referendum: subs. referendum, referendum: subs. referendo
referent	referent: subs. referente
refer	refer: referir
refill	refill: subs. troca
reflection	reflection: subs. reflexão
reflect	reflect: refletir
reform	reform: subs. reforma, reform: reformar
refusal	refusal: subs. negativa
refuse	refuse: rechaçar, refuse: recusar, refuse: rejeitar
regarding	regarding: pr. com respeito a, regarding: pr. quanto a, regarding: pr. no que diz respeito a
regard	regard: subs. consideração
regenerate	regenerate: regenerar
regional	regional: adj. regional
region	region: subs. região
register	register: subs. registo, register: subs. registro, register: registar, register: registrar, register: subs. registro
registration	registration: subs. inscrição
regret	regret: lamentar
regrettable	regrettable: adj. lamentável
regularly	regularly: adv. regularmente
regular	regular: adj. regular
regulate	regulate: regular
regulation	regulation: subs. controle
rehearsal	rehearsal: subs. ensaio
reinstate	reinstate: restabelecer
reiterate	reiterate: reiterar
relate	relate: relacionar
relation	relation: subs. relação
relationship	relationship: subs. relação
relatively	relatively: adv. relativamente
relative	relative: subs. parente, relative: adj. relativo
release	release: subs. emissão, release: subs. libertação, release: subs. versão, release: liberar
relief	relief: subs. relevo
religion	religion: subs. religião
religious	religious: adj. religioso
reluctantly	reluctantly: adv. de má vontade
rely	rely: confiar
remain	remain: ficar, remain: permanecer
remains	remains: n.pl. resto
remarkable	remarkable: adj. notável
remarkably	remarkably: adv. extraordinariamente
remark	remark: subs. comentário, remark: remarcar
remedial	remedial: adj. terapêutico
remedy	remedy: subs. remédio
remember	remember: recordar
remind	remind: recordar
reminiscence	reminiscence: subs. reminiscência
remit	remit: remeter
remote	remote: adj. remoto
removable	removable: adj. móvel
removal	removal: subs. eliminação
remove	remove: sacar
renewable	renewable: adj. renovável
renewal	renewal: subs. renovação
renew	renew: renovar
renovation	renovation: subs. renovação
rent	rent: alugar
repair	repair: subs. reparo, repair: consertar
repeatedly	repeatedly: adv. repetidamente
repeat	repeat: repetir
repercussion	repercussion: subs. repercussão
repetition	repetition: subs. repetição
replace	replace: substituir
reply	reply: responder
reporter	reporter: subs. repórter
report	report: subs. relatório, report: denunciar, report: informar
representation	representation: subs. representação
representative	representative: subs. representante, representative: adj. representativo
represent	represent: representar
repression	repression: subs. repressão
reprisal	reprisal: subs. represália
reproduce	reproduce: reproduzir
reproduction	reproduction: subs. reprodução
republican	republican: adj. republicano
republic	republic: subs. república
request	request: subs. petição, request: solicitar, request: pedir
requirement	requirement: subs. pré-requisito, requirement: subs. requisito
require	require: requerer
rescission	rescission: subs. rescisão
rescue	rescue: subs. resgate, rescue: resgatar
researcher	researcher: subs. pesquisador
research	research: subs. investigação, research: subs. pesquisa, research: subs. busca, research: investigar, research: pesquisar
resentment	resentment: subs. ressentimento
reservation	reservation: subs. reserva
reserve	reserve: subs. reserva, reserve: reservar
residence	residence: subs. residência
residential	residential: adj. residencial
resign	resign: demitir
resistance	resistance: subs. resistência
resistant	resistant: adj. resistente
resist	resist: resistir
resolution	resolution: subs. disposição, resolution: subs. resolução
resolve	resolve: resolver
resort	resort: subs. recurso, resort: percorrer, resort: recorrer
resource	resource: subs. recurso
respectively	respectively: adv. respectivamente
respective	respective: adj. respectivo
respect	respect: subs. respeito, respect: respeitar
respiratory	respiratory: adj. respiratório
responsibility	responsibility: subs. responsabilidade
responsible	responsible: adj. responsável
restart	restart: retomar
restaurant	restaurant: subs. restaurante
restitution	restitution: subs. restituição
restlessness	restlessness: n.sg. inquietude
restless	restless: adj. inquieto
restoration	restoration: subs. restauração
restore	restore: restaurar
restraint	restraint: subs. restrição
rest	rest: subs. resto, rest: descansar
restriction	restriction: subs. restrição
restrict	restrict: restringir
restructuring	restructuring: subs. reestruturação
resultant	resultant: adj. resultante
result	result: subs. placar, result: subs. resultado, result: resultar
resumption	resumption: subs. retomada
retain	retain: reter
retard	retard: atrasar
retirement	retirement: subs. aposentadoria, retirement: subs. aposentação
retort	retort: replicar
retouching	retouching: subs. retoque
retrieve	retrieve: recuperar
return	return: subs. regresso, return: devolver, return: retornar
reveal	reveal: revelar
revenge	revenge: subs. vingança
revenue	revenue: n.sg. ingresso, revenue: n.sg. rendimento, revenue: n.pl. rendimento
reverse	reverse: adj. inverso, reverse: investir
review	review: subs. revisão, review: subs. revista, review: revisar
revision	revision: subs. revisão
revolt	revolt: repugnar
revolutionary	revolutionary: adj. revolucionário
revolution	revolution: subs. revolução
revolving	revolving: adj. rotativo
reward	reward: subs. retribuição, reward: premiar
rhetorical	rhetorical: adj. retórico
rhetoric	rhetoric: subs. retórica
rhythm	rhythm: subs. ritmo
rich	rich: adj.sint. rico
ride	ride: subs. passeio
rider	rider: subs. cavaleiro, rider: subs. ginete
ridiculous	ridiculous: adj. ridículo
rid	rid: entregar, rid: livrar
right away	right away: adv. em seguida
right-hand	right-hand: adj. direito
right in front	right in front: adv. bem na frente
rightly	rightly: adv. correctamente
right off	right off: adv. imediatamente
right	right: subs. direita, right: subs. direito, right: adj. correcto, right: adj. direito, right: adv. bem
right through	right through: adv. completamente
rigid	rigid: adj. rígido
rigorous	rigorous: adj. rigoroso
rigour	rigour: subs. rigor
ring	ring: subs. anel, ring: subs. círculo
ripe	ripe: adj. maduro
rise	rise: subs. aumento, rise: subs. subida, rise: aumentar
risk	risk: subs. risco
rival	rival: subs. rival
river	river: subs. rio
road	road: subs. estrada, road: subs. rodovia, road: subs. via
roar	roar: rugir
robot	robot: subs. robô
rocket	rocket: subs. foguete
rock	rock: n.sg. rocha, rock: n.sg. rock, rock: n.pl. rocha
role	role: subs. função
roman	roman: adj. romano
romanticism	romanticism: subs. romantismo
romantic	romantic: adj. romântico
roof	roof: subs. teto
room	room: subs. habitação, room: subs. sala
rooster	rooster: subs. galo
root	root: subs. raiz
rose	rose: subs. rosa
rotary	rotary: adj. rotativo
roughly	roughly: adv. aproximadamente
rough	rough: adj.sint. áspero
roundly	roundly: adv. rotundamente
round off	round off: acabar
round	round: subs. rodada, round: subs. assalto, round: adj.sint. redondo
route	route: subs. rota, route: subs. percurso
row	row: subs. bicha, row: subs. fila
royal	royal: adj. real
rubber	rubber: subs. borracha
rubbish	rubbish: n.sg. lixo, rubbish: n.sg. lixo
rub	rub: esfregar
rudder	rudder: subs. timão
ruin	ruin: subs. ruína
ruler	ruler: subs. governante
rule	rule: subs. regulamento, rule: subs. regra
rumble	rumble: subs. boato, rumble: subs. rumor
runner	runner: subs. corredor
running	running: subs. carreira
run	run: subs. carreira, run: correr, run: funcionar
rural	rural: adj. rural
russian	Russian: subs. russo, Russian: adj. russo
ruthless	ruthless: adj. cruel
sack	sack: subs. saco, sack: despedir
sacred	sacred: adj. sagrado
sacrifice	sacrifice: subs. sacrifício, sacrifice: sacrificar
sadly	sadly: adv. tristemente
sad	sad: adj. triste
safe	safe: adj.sint. seguro
safety	safety: subs. segurança
sailing	sailing: subs. navegação
sailor	sailor: subs. marinheiro
sail	sail: subs. vela, sail: navegar
saint	saint: subs. santo
salary	salary: subs. salário
sale	sale: subs. venda
salvation	salvation: subs. salvação
same	same: adj. mesmo
sample	sample: subs. amostra, sample: subs. mostra
sanctuary	sanctuary: subs. santuário
sand	sand: subs. areia
sanitary	sanitary: adj. sanitário
satellite	satellite: subs. satélite
satiety	satiety: subs. saciedade
satisfaction	satisfaction: subs. satisfação
satisfactory	satisfactory: adj. satisfatório
satisfy	satisfy: colmar, satisfy: satisfazer
saturday	Saturday: subs. sábado
save	save: poupar, save: guardar, save: salvar
saving	saving: subs. poupança
say	say: dizer
scale	scale: n.pl. escada, scale: n.sg. escada
scalp	scalp: subs. couro
scandal	scandal: subs. escândalo
scarcely	scarcely: adv. dificilmente
scarce	scarce: adj. escasso
scare	scare: assustar, scare: espantar
scene	scene: subs. cena
scenography	scenography: subs. cenografia
schedule	schedule: subs. horário, schedule: subs. programa, schedule: planificar
scheme	scheme: subs. esquema
scholarship	scholarship: subs. bolsa
school	school: subs. colégio, school: adj. escolar
science	science: subs. ciência
scientific	scientific: adj. científico
scientist	scientist: subs. cientista
scope	scope: subs. alcance
score	score: subs. resultado, score: marcar
scottish	Scottish: subs. escocês, Scottish: adj. escocês
scour	scour: registar
scream	scream: gritar
screen	screen: subs. tela
script	script: subs. guião, script: subs. roteiro
seafarer	seafarer: subs. navegante
seal	seal: subs. selo
search for	search for: procurar
search	search: subs. busca, search: procurar
sea	sea: subs. mar
season	season: subs. estação, season: subs. temporada
seat	seat: subs. localidade, seat: subs. cadeira, seat: subs. cadeirão, seat: subs. assento, seat: sentar
seclusion	seclusion: subs. reclusão
secondary	secondary: adj. secundário
second	second: subs. segundo
secretariat	secretariat: subs. secretariado
secretary	secretary: subs. secretário
secrete	secrete: ocultar
secret	secret: subs. segredo
section	section: subs. secção, section: subs. seção
sector	sector: subs. sector, sector: subs. setor
sect	sect: subs. seita
secure	secure: adj. seguro, secure: assegurar
security	security: subs. segurança
seduce	seduce: seduzir
seduction	seduction: subs. sedução
seed	seed: subs. semente
seek	seek: procurar
seemingly	seemingly: adv. aparentemente
seem	seem: parecer
see	see: ver
seize	seize: confiscar
selection	selection: subs. selecção, selection: subs. seleção
selective	selective: adj. selectivo, selective: adj. seletivo
select	select: seleccionar, select: selecionar
selfishness	selfishness: subs. egoísmo
sell	sell: vender
semester	semester: subs. semestre
seminar	seminar: subs. seminário
senator	senator: subs. senador
send back	send back: sep. voltar
send in	send in: enviar
send	send: enviar
sense	sense: subs. sentido, sense: notar, sense: reparar
sensitive	sensitive: adj. sensível
sensitivity	sensitivity: subs. sensibilidade
sentence	sentence: subs. sentença, sentence: subs. frase, sentence: sentenciar
sentimental	sentimental: adj. sentimental
separate	separate: separar
separation	separation: subs. separação
september	September: subs. setembro
sequence	sequence: subs. sequência, sequence: subs. seqüência
serbian	Serbian: subs. sérvio
series	series: subs. série
seriously now	seriously now: adv. seriamente
seriously	seriously: adv. seriamente
seriousness	seriousness: subs. seriedade
serious	serious: adj. sério
server	server: subs. servidor
serve	serve: servir
service	service: subs. serviço
servitude	servitude: subs. servidão
session	session: subs. sessão
setscrew	setscrew: subs. prisioneiro
set	set: subs. conjunto, set: pôr
settle	settle: resolver
set up	set up: sep. instalar, set up: sep. montar, set up: sep. convocar
seventeen	seventeen: num. dezassete, seventeen: num. dezessete
several	several: det.ind. vário, several: det. vário
severe	severe: adj. severo, severe: adj. grave
sewing	sewing: subs. costura
sex	sex: subs. sexo
sexually	sexually: adv. sexualmente
sexual	sexual: adj. sexual
shade	shade: subs. sombra
shadow	shadow: subs. sombra
shake	shake: abalar, shake: sacudir
shallow	shallow: adj. superficial
shame	shame: subs. vergonha
shape	shape: subs. forma
shareholder	shareholder: subs. accionista, shareholder: subs. acionista
share	share: subs. participação, share: compartilhar
sharp	sharp: adj.sint. agudo
shatter	shatter: destroçar
shave	shave: barbear
shed	shed: derramar
sheep	sheep: subs. ovelha
sheet	sheet: subs. folha
shelter	shelter: subs. refúgio
shepherd	shepherd: subs. pastor
shield	shield: subs. escudo
shift	shift: subs. turno, shift: subs. mudança, shift: mudar, shift: mover
shine	shine: brilhar
shiny	shiny: adj.sint. faiscante, shiny: adj.sint. reluzente
ship	ship: subs. barco, ship: subs. nave, ship: embarcar
shipwreck	shipwreck: subs. naufrágio
shirt	shirt: subs. camisa
shiver	shiver: tremer
shocking	shocking: adj. impressionante
shock	shock: subs. choque
shoot	shoot: disparar
shop	shop: subs. loja
shortly afterwards	shortly afterwards: adv. pouco depois
short	short: adj.sint. curto, short: adj.sint. baixo
shot	shot: subs. tiro, shot: subs. disparo, shot: subs. rasgo
shout	shout: subs. grito, shout: chamar, shout: gritar
show	show: subs. espectáculo, show: subs. espetáculo, show: demonstrar, show: mostrar
show up	show up: aparecer
shut down	shut down: sep. fechar
shut	shut: fechar
shyly	shyly: adv. timidamente
shy	shy: adj.sint. acanhado, shy: adj.sint. tímido
sick	sick: adj.sint. doente
side	side: subs. lado
sigh	sigh: subs. suspiro, sigh: suspirar
sight	sight: subs. vista
sight unseen	sight unseen: adv. às cegas
signal	signal: subs. senha, signal: subs. sinal, signal: assinalar
signature	signature: subs. assinatura, signature: subs. firma, signature: subs. assinatura
significance	significance: subs. importância, significance: subs. significação
significant	significant: adj. significativo
signpost	signpost: subs. painel
sign	sign: subs. sinal, sign: subs. signo, sign: assinar, sign: firmar
silence	silence: subs. silêncio
silent	silent: adj. silencioso
silly	silly: adj.sint. tonto
silver	silver: subs. prata
similar	similar: adj. similar
simple	simple: adj.sint. simples, simple: adj.sint. singelo
simply	simply: adv. simplesmente, simply: adv. singelamente
simulate	simulate: simular
simultaneously	simultaneously: adv. simultaneamente
simultaneous	simultaneous: adj. simultâneo
sincerely	sincerely: adv. sinceramente
sincerity	sincerity: subs. sinceridade
since	since: cnjadv. já que, since: cnjadv. desde que, since: pr. desde
sindical	sindical: adj. sindical
singer	singer: subs. cantor, singer: subs. cantor, singer: subs. cantor
singing	singing: subs. canto
single	single: adj. sozinho
sing	sing: cantar
singular	singular: adj. singular
sin	sin: pecar
sir	sir: subs. senhor
sister	sister: subs. irmão
sit down	sit down: sentar
site	site: subs. lugar
sit	sit: sentar
situate	situate: situar
situation	situation: subs. situação
sixteen	sixteen: num. dezasseis, sixteen: num. dezesseis
size	size: subs. medida
skeleton	skeleton: subs. esqueleto
skeptical	skeptical: adj. céptico, skeptical: adj. cético
skillful	skillful: adj. hábil
skill	skill: subs. habilidade
skin	skin: subs. pele
skirt	skirt: subs. saia
ski	ski: subs. esqui, ski: subs. esquí
sky	sky: subs. céu
slang	slang: subs. jargão
slave	slave: subs. escravo
sleeplessness	sleeplessness: subs. insónia, sleeplessness: subs. insônia
sleep	sleep: dormir
slice	slice: subs. corte
slightly	slightly: adv. lestamente, slightly: adv. levianamente, slightly: adv. ligeiramente
slight	slight: adj. leve
sling	sling: lançar
slip	slip: escorregar, slip: resvalar
slope	slope: subs. subida, slope: subs. vertente, slope: subs. pendente
slowly	slowly: adv. lentamente, slowly: adv. devagar
slowness	slowness: subs. lentidão
slow	slow: adj.sint. lento, slow: adv. devagar
slump	slump: subs. recessão
small	small: adj.sint. pequeno
smart	smart: adj.sint. pronto
smash	smash: subs. choque, smash: romper
smell	smell: subs. cheiro, smell: subs. olfacto, smell: subs. olfato, smell: cheirar, smell: recender
smile	smile: subs. sorriso, smile: sorrir
smith	smith: subs. ferreiro
smoke	smoke: subs. fumaça, smoke: fumar
snake	snake: subs. serpente
snow	snow: subs. neve
socialist	socialist: subs. socialista, socialist: adj. socialista
socially	socially: adv. socialmente
social	social: adj. social
society	society: subs. sociedade
sock	sock: subs. meia
soften	soften: suavizar
softness	softness: subs. macieza, softness: subs. suavidade
soft	soft: adj.sint. suave, soft: adj.sint. brando, soft: adj.sint. macio
soil	soil: subs. terra, soil: subs. chão, soil: subs. solo
soldier	soldier: subs. soldado
solely	solely: adv. só
solemn	solemn: adj. solene
solicitor	solicitor: subs. advogado
solicit	solicit: solicitar
solidarity	solidarity: subs. solidariedade
solid	solid: adj.sint. sólido
solitary	solitary: adj. solitário
solitude	solitude: subs. solidão
solution	solution: subs. solução
solve	solve: solucionar
somebody	somebody: prsubs. alguém
someone	someone: prsubs. alguém
some	some: det.qnt.pl. um, some: det.qnt.sp. algum, some: det. algum, some: det.qnt. certo, some: prn.tn.mf.pl. algum
something	something: prn.tn.nt. algo
sometimes	sometimes: adv. as vezes, sometimes: adv. às vezes
so much	so much: adv. tanto
song	song: subs. canto, song: subs. canção
son	son: subs. filho, son: n.sg. filho
sooner or later	sooner or later: adv. mais cedo ou mais tarde
soon	soon: adv. cedo, soon: adv. pronto
sort	sort: subs. classe, sort: ordenar
so	so: preadv. tão
so that	so that: cnjadv. a fim de que, so that: cnjadv. de modo que, so that: cnjadv. de sorte que, so that: cnjadv. porque
soul	soul: subs. alma
sound	sound: subs. som, sound: soar
source	source: subs. fonte
south	south: subs. sul
southwest	southwest: subs. sudoeste
sovereign	sovereign: subs. soberano
sovereignty	sovereignty: subs. soberania
soviet	Soviet: adj. soviético
sow	sow: subs. porco
soybean	soybean: subs. soja
space	space: subs. espaço, space: adj. espacial
spaniard	Spaniard: subs. castelhano, Spaniard: subs. espanhol
spanish	Spanish: adj. espanhol, Spanish: adj. castelhano
spare	spare: subs. troca, spare: poupar
spatial	spatial: adj. espacial
speaker	speaker: subs. interlocutor, speaker: subs. palestrante, speaker: subs. poente
speak	speak: falar
specialist	specialist: subs. especialista
specially	specially: adv. especialmente
special	special: adj. especial
species	species: subs. espécie
specifically	specifically: adv. concretamente, specifically: adv. especificamente
specific	specific: adj. específico
specify	specify: especificar
spectacular	spectacular: adj. espectacular, spectacular: adj. espetacular
spectrum	spectrum: subs. espectro
speculation	speculation: subs. especulação
speculative	speculative: adj. especulativo
speech	speech: subs. fala, speech: subs. discurso
speed	speed: subs. velocidade, speed: acelerar
spell	spell: subs. período
spend	spend: gastar, spend: passar
spider	spider: subs. aranha
spill	spill: derramar
spirit	spirit: subs. álcool, spirit: subs. espírito
spiritual	spiritual: adj. espiritual
splendour	splendour: subs. esplendor
split	split: subs. ruptura, split: partir
spokesman	spokesman: subs. porta-voz
spokeswoman	spokeswoman: subs. porta-voz
sponsor	sponsor: patrocinar
sporting	sporting: adj. desportivo
sportive	sportive: adj. desportivo, sportive: adj. esportivo
sportsman	sportsman: subs. desportista
sport	sport: subs. desporto, sport: subs. esporte
spot	spot: subs. lugar, spot: subs. mancha, spot: subs. grão
spread	spread: estender, spread: divulgar
spring	spring: subs. fonte, spring: subs. primavera, spring: saltar
square	square: subs. praça
stadium	stadium: subs. estádio
staff	staff: n.sg. pessoal, staff: n.pl. pessoal
stage	stage: subs. cenário, stage: subs. palco, stage: subs. etapa
stain	stain: subs. mancha
stair	stair: subs. escada, stair: n.pl. escada, stair: subs. degrau
stake	stake: subs. participação
stamp	stamp: subs. selo
standard	standard: subs. standard, standard: adj. regular
stand	stand: subs. apoio, stand: subs. posição, stand: aguentar, stand: estar
star	star: subs. estrela, star: subs. estrella
start	start: subs. arranque, start: subs. saída, start: subs. início, start: começar
statement	statement: subs. declaração
state-of-the-art	state-of-the-art: adj. moderno
state	state: subs. estado, state: adj. estatal, state: declarar, state: propor
station	station: subs. estação
statistical	statistical: adj. estatístico
statue	statue: subs. estátua
status	status: subs. estado
statute	statute: subs. estatuto
statutory	statutory: adj. estatutário, statutory: adj. regulamentar
stay	stay: subs. estadia, stay: subs. estância, stay: ficar
steal	steal: roubar
steam	steam: subs. vapor
steel	steel: subs. aço
stem	stem: subs. raiz
step into	step into: entrar
step	step: subs. passo
stick	stick: subs. pau
still	still: adv. ainda, still: adv. mesmo
stimulate	stimulate: estimular
stimulation	stimulation: subs. estimulação
stimulus	stimulus: subs. estímulo
stink	stink: subs. fedor, stink: subs. pejo, stink: subs. pudor
stipulate	stipulate: estipular
stir	stir: baralhar
stir up	stir up: sep. remover
stockholder	stockholder: subs. accionista
stomach	stomach: subs. estômago, stomach: subs. estômago
stone	stone: subs. osso
stop	stop: parar, stop: deter
store	store: subs. loja, store: armazenar
storm	storm: subs. tormenta
story	story: subs. história
stove	stove: subs. estufa
straight away	straight away: adv. em seguida
straight	straight: adj. recto, straight: adj. reto
straight through	straight through: adv. completamente
strain	strain: subs. tensão, strain: subs. pressão, strain: esticar
strange	strange: adj.sint. estranho
strategic	strategic: adj. estratégico
strategy	strategy: subs. estratégia
stream	stream: subs. corrente
streetcar	streetcar: subs. eléctrico
street	street: subs. rua
strengthen	strengthen: fortalecer
strength	strength: subs. força
stress	stress: subs. tensão, stress: acentuar
stretch	stretch: esticar
strictly	strictly: adv. estritamente
strict	strict: adj. estrito
strident	strident: adj. estridente
strike	strike: subs. greve, strike: golpear, strike: atacar
string	string: subs. corrente
strip	strip: subs. banda, strip: subs. fita
stroke	stroke: subs. ataque, stroke: subs. golpe, stroke: acariciar
strongly	strongly: adv. fortemente
strong	strong: adj.sint. forte
structural	structural: adj. estrutural
structure	structure: subs. estrutura
struggle	struggle: subs. luta, struggle: lutar
strut	strut: subs. montante
student	student: n.sg. aluno, student: n.sg. aluno, student: n.sg. aluno, student: n.sg. aluno, student: n.pl. aluno, student: n.pl. aluno, student: n.pl. aluno, student: n.pl. aluno, student: subs. estudante
studio	studio: subs. estudo, studio: subs. estúdio
study	study: subs. estudo, study: subs. estúdio, study: estudar
stuff	stuff: subs. material
stupidity	stupidity: subs. burrice, stupidity: subs. estupidez
stupid	stupid: adj. estúpido
style	style: subs. estilo
subhead	subhead: subs. subtítulo
subject	subject: subs. sujeito, subject: subs. tema, subject: subs. assunto, subject: subs. matéria, subject: adj. sujeito, subject: submeter
sublime	sublime: adj. sublime
submit	submit: entregar, submit: submeter
subscription	subscription: subs. assinatura
substance	substance: subs. substância
substitute	substitute: substituir
subtract	subtract: restar
subway	subway: subs. metro
successive	successive: adj. sucessivo
successor	successor: subs. sucessor
success	success: subs. sucesso, success: subs. êxito
such as	such as: pr. como
suddenly	suddenly: adv. de repente
sudden	sudden: adj. repentino, sudden: adj. súbito
suffering	suffering: subs. sofrimento
suffer	suffer: padecer
suffice	suffice: bastar
sufficiently	sufficiently: adv. suficientemente
sufficient	sufficient: adj. suficiente
suffocate	suffocate: asfixiar
sugar	sugar: subs. açúcar
suggestion	suggestion: subs. sugestão
suggest	suggest: sugerir
suicide	suicide: subs. suicídio
suitcase	suitcase: subs. mala, suitcase: subs. maleta
suit	suit: subs. traje, suit: subs. vestido, suit: convir, suit: adaptar
summary	summary: subs. sumário
summer	summer: subs. verão
summit	summit: subs. cimeira
summon	summon: convocar
sum	sum: subs. soma
sunday	Sunday: subs. domingo
sunset	sunset: subs. véspera
sun	sun: subs. sol
superb	superb: adj. magnífico
superficial	superficial: adj. superficial
superior	superior: adj. superior
supermarket	supermarket: subs. supermercado
supplement	supplement: subs. suplemento
supplier	supplier: subs. provedor
supply	supply: subs. fornecimento, supply: fornecer
supporter	supporter: subs. seguidor
support	support: subs. apoio
supposedly	supposedly: adv. supostamente
suppose	suppose: supor
suppress	suppress: suprimir
supreme	supreme: adj. supremo
sure enough	sure enough: adv. efectivamente, sure enough: adv. efetivamente
surely	surely: adv. seguramente, surely: adv. por certo
sure	sure: adj.sint. seguro, sure: adv. seguro
surpass	surpass: superar
surprise	surprise: subs. assombro, surprise: subs. surpresa, surprise: assombrar, surprise: surpreender
surprisingly	surprisingly: adv. assombrosamente, surprisingly: adv. surpreendentemente
surprising	surprising: adj. surpreendente
surroundings	surroundings: n.pl. meio
surround	surround: rodear
surveillance	surveillance: subs. vigilância
survival	survival: subs. sobrevivência
survive	survive: sobreviver
susceptible	susceptible: adj. susceptível
suspect	suspect: suspeitar
suspend	suspend: suspender
suspension	suspension: subs. suspensão
suspicion	suspicion: subs. suspeita
suspicious	suspicious: adj. suspeito
sustain	sustain: sustentar
swear	swear: jurar
sweat	sweat: n.sg. suor, sweat: n.pl. suor, sweat: subs. suor
swedish	Swedish: adj. sueco
sweep	sweep: varrer
sweet	sweet: adj.sint. doce
swiftly	swiftly: adv. rapidamente
swim	swim: nadar
swing	swing: subs. mudança
swiss	Swiss: subs. suíço, Swiss: adj. suíço
switchboard	switchboard: subs. central
switch	switch: subs. mudança
sword	sword: subs. espada
symbolic	symbolic: adj. simbólico
symbolism	symbolism: subs. simbolismo
symbolize	symbolize: simbolizar
symbol	symbol: subs. símbolo
symptom	symptom: subs. sintoma
syndrome	syndrome: subs. síndroma
synthesis	synthesis: subs. síntese
systematically	systematically: adv. sistematicamente
systematic	systematic: adj. sistemático, systematic: adj. sistémico
system	system: subs. sistema
table	table: subs. mesa, table: subs. tabela, table: subs. tabela
taboo	taboo: subs. tabu
tackle	tackle: empreender
tactical	tactical: adj. táctico, tactical: adj. tático
tactics	tactics: subs. táctica, tactics: subs. tática
tail	tail: subs. bicha
take advantage of	take advantage of: aproveitar
take away	take away: sep. sacar
take care	take care: cuidar
taken altogether	taken altogether: adv. ao todo
take off	take off: sep. sacar
take out	take out: sep. sacar
take part	take part: intervir, take part: participar
take	take: pegar, take: segurar, take: fazer, take: trazer, take: tomar
talent	talent: subs. talento
tale	tale: subs. conto
talk	talk: falar
tall	tall: adj.sint. alto
tank	tank: subs. tanque, tank: subs. depósito
tape	tape: subs. fita
target	target: subs. objectivo, target: subs. alvo, target: apontar
task	task: subs. tarefa
taste	taste: provar
taut	taut: adj. tenso, taut: adj. tenso, taut: adj. tenso
taxation	taxation: n.sg. imposto, taxation: n.pl. imposto
taxi	taxi: subs. táxi
taxpayer	taxpayer: subs. contribuinte
tax	tax: subs. imposto, tax: gravar
teacher	teacher: subs. maestro
teaching	teaching: subs. ensinamento, teaching: subs. ensino
teach	teach: ensinar
team	team: subs. equipa, team: subs. equipe, team: subs. time
tear	tear: subs. lágrima
tea	tea: subs. chá
technically	technically: adv. tecnicamente
technical	technical: adj. técnico
technician	technician: subs. técnico
technological	technological: adj. tecnológico
teenager	teenager: subs. adolescente
telecommunication	telecommunication: subs. telecomunicação
telephone	telephone: subs. telefone
telephonic	telephonic: adj. telefónico, telephonic: adj. telefônico
telescope	telescope: subs. telescópio
television	television: subs. televisão, television: subs. tevê
tell	tell: dizer
temperature	temperature: subs. temperatura
temple	temple: subs. templo
temporarily	temporarily: adv. temporariamente
temporary	temporary: adj. provisório
tempt	tempt: tentar
tendency	tendency: subs. tendência
tender	tender: subs. oferta, tender: adj.sint. meigo, tender: adj.sint. tenro, tender: adj.sint. terno
tend	tend: tender
ten hundred	ten hundred: num. mil, ten hundred: num. milhar
tennis	tennis: subs. tênis, tennis: n.ND. tênis
tennist	tennist: subs. tenista
tension	tension: subs. tensão
ten	ten: n.pl. dezena, ten: num. dez
terminal	terminal: subs. terminal, terminal: adj. terminal
term	term: subs. termo, term: subs. término, term: subs. prazo
terrain	terrain: subs. terreno
terrestrial	terrestrial: adj. terrestre
terrible	terrible: adj. terrível
territorial	territorial: adj. territorial
territory	territory: subs. território
terrorism	terrorism: subs. terrorismo
terrorist	terrorist: subs. terrorista, terrorist: adj. terrorista
terror	terror: subs. terror
test	test: subs. teste, test: subs. prova, test: testar, test: provar
textile	textile: adj. têxtil
text	text: subs. texto
thai	Thai: adj. tailandês
thankfully	thankfully: adv. felizmente
thanks to	thanks to: pr. graças a
that is to say	that is to say: adv. isto é
that	that: det.dem. aquele, that: det. aquele, that: cnjsub. que, that: prn.tn.mf.sg. aquilo, that: prn.tn.mf.pl. aquele, that: prn.tn.mf. aquele, that: rel. que
theater	theater: subs. teatro
theatre	theatre: subs. teatro
theatrical	theatrical: adj. teatral
theft	theft: subs. roubo
theirs	theirs: adj. seu, theirs: prn.pos.mf.sp. o seu
their	their: det.pos.sp. o seu
thematic	thematic: adj. temático
theme	theme: subs. tema
then and there	then and there: adv. em seguida
then	then: adv. então
the one	the one: prn.tn.mf. o, the one: prn.tn.mf. o, the one: prn.tn.mf. o, the one: prn.tn.mf. o, the one: prn.tn.mf. o
the one who	the one who: rel.nn.mf.sg. quem
theoretically	theoretically: adv. teoricamente
therapeutic	therapeutic: adj. terapêutico
therapy	therapy: subs. terapia
thereafter	thereafter: adv. depois
there again	there again: adv. ademais
there and then	there and then: adv. em seguida
thereby	thereby: adv. assim
therefore	therefore: cnjadv. portanto, therefore: cnjadv. logo
there	there: adv. acolá, there: adv. lá
thermal	thermal: adj. térmico
the same	the same: adv. igual
thesis	thesis: subs. tese
the	the: det.def.sp. o, the: det.def.sp. o, the: det.def.sp. o, the: det. o, the: det. o
the whole while	the whole while: adv. o tempo todo
thief	thief: subs. ladrão, thief: subs. ladrão, thief: subs. ladrão
thing	thing: subs. coisa
thinking	thinking: subs. pensamento
think	think: acreditar, think: crer, think: pensar, think: opinar
thin	thin: adj.sint. delgado, thin: adj.sint. franzino
third	third: subs. terço
thirteen	thirteen: num. treze
this	this: det.dem. este, this: det.dem. esse, this: prn.tn.mf.sg. isso, this: prn.tn.mf.sg. isto, this: prn.tn.mf.pl. este, this: prn.tn.mf. esse, this: prn.tn.mf. este
this way	this way: adv. desta guisa
those who	those who: rel.nn.mf.pl. quem
though	though: cnjadv. ainda que
thought	thought: subs. pensamento
thousand	thousand: num. mil, thousand: num. milhar
thread	thread: subs. fio
threat	threat: subs. ameaça
threshold	threshold: subs. limiar, threshold: subs. ombreira, threshold: subs. umbral
thrill	thrill: subs. emoção, thrill: emocionar
throat	throat: subs. garganta
throne	throne: subs. trono
throughout	throughout: pr. durante
throw	throw: jogar
thrust	thrust: empurrar
thursday	Thursday: subs. quinta-feira, Thursday: n.ND. quinta-feira, Thursday: n.ND. quinta-feira
thus	thus: adv. assim
ticket	ticket: subs. bilhete, ticket: subs. entrada
tide	tide: subs. maré
tie	tie: subs. vínculo, tie: subs. empate, tie: atar
tiger	tiger: subs. tigre
tighten	tighten: apertar
tightly	tightly: adv. estreitamente
time and time again	time and time again: adv. repetidamente
timely	timely: adj. oportuno
timetable	timetable: subs. horário
time	time: subs. hora, time: subs. tempo, time: n.ND. tempo, time: n.ND. tempo, time: subs. vez
tinzaparin sodium	tinzaparin sodium: subs. tinzaparina sódica
tinzaparin	tinzaparin: subs. tinzaparina
tip	tip: subs. conselho, tip: subs. ponta, tip: verter
tire	tire: subs. pneu
tissue	tissue: subs. tecido, tissue: subs. lenço
title	title: subs. título, title: titular
tobacco	tobacco: subs. tabaco
to be serious	to be serious: adv. seriamente
to capacity	to capacity: adv. completamente
today	today: adv. hoje
toe	toe: subs. dedo
together	together: adj. junto
tolerate	tolerate: tolerar
tomorrow	tomorrow: adv. amanhã
toneless	toneless: adj. fluxo
tone	tone: subs. tom
tongue	tongue: subs. língua
tonne	tonne: subs. tonelada
ton	ton: subs. tonelada
tool	tool: subs. ferramenta
too much	too much: adv. demais, too much: adv. demasiadamente, too much: adv. demasiado
tooth	tooth: subs. dente
too	too: adv. também
topic	topic: subs. tema
top	top: adj. superior, top: coroar
torrential	torrential: adj. torrencial
torrent	torrent: subs. torrente
torture	torture: subs. tortura, torture: torturar
to size	to size: adv. sob medida
totally	totally: adv. cabalmente, totally: adv. totalmente
total	total: subs. total, total: adj. total
to the ground	to the ground: adv. completamente
to	to: pr. a
touch	touch: tocar
toughen	toughen: endurecer
tough	tough: adj.sint. duro
tourism	tourism: subs. turismo
tourist	tourist: subs. turista
tournament	tournament: subs. torneio
tour	tour: subs. visita
towards	towards: pr. para
tower	tower: subs. torre
to wit	to wit: adv. isto é
town council	town council: subs. prefeitura
town hall	town hall: subs. prefeitura
town	town: subs. cidade, town: subs. localidade
toxic	toxic: adj. tóxico
toxin	toxin: subs. toxina
toy	toy: subs. brinquedo
trace back	trace back: sep. remontar
trace	trace: localizar
track	track: subs. pista
trademark	trademark: subs. marca
trader	trader: subs. comerciante
trade	trade: subs. comércio
trading	trading: subs. comércio
traditionally	traditionally: adv. tradicionalmente
traditional	traditional: adj. tradicional
tradition	tradition: subs. tradição
trafficker	trafficker: subs. traficante
trafficking	trafficking: subs. tráfico
traffic	traffic: subs. trânsito, traffic: subs. tráfego, traffic: subs. tráfico
tragedy	tragedy: subs. tragédia
tragic	tragic: adj. trágico
trainer	trainer: subs. treinador
training	training: subs. treinamento, training: subs. treino, training: subs. formação
train	train: subs. comboio, train: subs. trem, train: treinar
tramcar	tramcar: subs. eléctrico
tram	tram: subs. eléctrico
tramway	tramway: subs. eléctrico
transaction	transaction: subs. transacção, transaction: subs. transação
transact	transact: tramitar
transfer	transfer: subs. transferência
transformation	transformation: subs. transformação
transform	transform: transformar
transition	transition: subs. transição
translate	translate: traduzir
translation	translation: subs. tradução
translator	translator: subs. tradutor
transmission	transmission: subs. transmissão
transmit	transmit: transmitir
transparency	transparency: subs. transparência
transparent	transparent: adj. transparente
transplant	transplant: transplantar
transportation	transportation: subs. transporte
transport	transport: subs. transporte, transport: transportar
trap	trap: subs. armadilha, trap: apanhar, trap: atrapar, trap: enganar, trap: subs. armadilha
traveller	traveller: subs. viajante
travel	travel: subs. viagem, travel: viajar
treasure	treasure: subs. tesouro
treatment	treatment: subs. tratamento
treat	treat: tratar
treaty	treaty: subs. tratado
tree	tree: subs. árvore
tremble	tremble: tremer
tremendous	tremendous: adj. enorme
tremor	tremor: subs. tremor
trend	trend: subs. tendência
trial	trial: subs. prova, trial: subs. julgamento
tribe	tribe: subs. tribo
tribute	tribute: subs. tributo
trick	trick: subs. truque
tricky	tricky: adj.sint. delicado
trigger	trigger: provocar
trillion	trillion: subs. bilião
trip	trip: subs. viagem
triumph	triumph: subs. triunfo
troop	troop: subs. tropa
trophy	trophy: subs. troféu
tropical	tropical: adj. tropical
trouble	trouble: subs. problema
truce	truce: subs. trégua
truck	truck: subs. caminhão
true	true: adj.sint. verdadeiro, true: adj.sint. verdadeiro, true: adj.sint. verdadeiro
truly	truly: adv. verdadeiramente
trunk	trunk: subs. tronco
trust	trust: subs. confiança, trust: confiar
truth	truth: subs. verdade
try	try: tentar, try: testar, try: provar
t-shirt	t-shirt: subs. t-shirt
tube	tube: subs. metro
tuesday	Tuesday: subs. terça-feira, Tuesday: n.ND. terça-feira, Tuesday: n.ND. terça-feira
tumor	tumor: subs. tumor
tunnel	tunnel: subs. túnel
turkish	Turkish: subs. turco, Turkish: adj. turco
turn off	turn off: sep. apagar
turn out	turn out: resultar
turnover	turnover: subs. facturação, turnover: subs. faturação
turn	turn: subs. abóbada, turn: subs. volta, turn: subs. turno, turn: girar
turn up	turn up: aparecer
twelve	twelve: num. doze
twist	twist: subs. giro, twist: torcer
twofold	twofold: adj. duplo
tycoon	tycoon: subs. magnata
type	type: subs. tipo, type: n.ND. tipo, type: escrever
typically	typically: adv. tipicamente
tyrant	tyrant: subs. tirano
tyre	tyre: subs. pneu
ugly	ugly: adj.sint. feio
ultimately	ultimately: adv. afinal de contas, ultimately: adv. finalmente
ultimate	ultimate: adj. definitivo
umbilical	umbilical: adj. umbilical
unable	unable: adj. incapaz
unacceptable	unacceptable: adj. inaceitável
unanimity	unanimity: subs. unanimidade
unanimous	unanimous: adj. unânime
unavoidable	unavoidable: adj. inevitável
unbelievably	unbelievably: adv. incrivelmente
unblock	unblock: desbloquear
uncertainty	uncertainty: subs. incerteza
uncertain	uncertain: adj. incerto
unchain	unchain: desencadear
uncle	uncle: subs. tio
uncoiling	uncoiling: subs. desenvolvimento
unconditional	unconditional: adj. incondicional
undergo	undergo: experimentar
underline	underline: sublinhar
understanding	understanding: subs. entendimento
understand	understand: entender
undertake	undertake: empreender
undertaking	undertaking: subs. tarefa
under	under: pr. debaixo de, under: pr. embaixo de, under: pr. sob, under: adv. embaixo, under: adv. baixo
undo	undo: desfazer, undo: desmanchar
undress	undress: desnudar, undress: despir, undress: despojar
unemployment	unemployment: subs. desemprego
unexpected	unexpected: adj. inesperado
unfairly	unfairly: adv. injustamente
unfair	unfair: adj. injusto
unforeseen	unforeseen: adj. imprevisto
unify	unify: unificar
unilaterally	unilaterally: adv. unilateralmente
unilateral	unilateral: adj. unilateral
unintentionally	unintentionally: adv. involuntariamente
union	union: subs. sindicato, union: subs. união
unique	unique: adj. único
unite	unite: unir
unit	unit: subs. unidade
unity	unity: subs. unidade
universal	universal: adj. universal
universe	universe: subs. universo
university	university: subs. universidade, university: adj. universitário
unlikely	unlikely: adj. improvável
unlike	unlike: adj. diferente
unrest	unrest: subs. mal-estar
unripe	unripe: adj. verde
unseen	unseen: adj. oculto
unstable	unstable: adj. instável
unsteadiness	unsteadiness: subs. instabilidade
unsure	unsure: adj. inseguro
until	until: pr. até
unusual	unusual: adj. insólito
unveil	unveil: descobrir
unwillingly	unwillingly: adv. a contragosto
update	update: actualizar
upon	upon: pr. a
uppermost	uppermost: adv. em cima
upper	upper: adj. superior
upset	upset: virar
up-to-date	up-to-date: adj. actual
up to	up to: pr. até
up	up: adv. acima
upward	upward: adv. acima
uranium	uranium: subs. urânio
urban	urban: adj. urbano
urgency	urgency: subs. urgência
urgently	urgently: adv. urgentemente
urgent	urgent: adj. urgente
urge	urge: subs. impulso, urge: instar
urn	urn: subs. urna
usage	usage: subs. uso
useful	useful: adj. útil
useless	useless: adj. inútil
user	user: subs. usuário, user: subs. utente
use	use: subs. uso, use: usar, use: utilizar
usually	usually: adv. normalmente, usually: adv. habitualmente
usual	usual: adj. habitual
utility	utility: subs. utilidade
utilization	utilization: subs. utilização
utterly	utterly: adv. absolutamente
vacancy	vacancy: subs. vaga
vacation	vacation: n.sg. férias, vacation: n.pl. férias
vaccine	vaccine: subs. vacina
valencian	Valencian: adj. valenciano
valid	valid: adj. válido, valid: adj. vigente
valley	valley: subs. vale
valuable	valuable: adj. valioso
value	value: subs. valor, value: valorizar, value: ponderar
vanity	vanity: subs. vaidade
variation	variation: subs. variação
varied	varied: adj. diverso
various	various: det.ind. vário
vary	vary: variar
vast	vast: adj.sint. vasto
vehicle	vehicle: subs. veículo, vehicle: subs. viatura
velocity	velocity: subs. velocidade
venture	venture: subs. aventura
venue	venue: subs. local
verbal	verbal: adj. verbal
verb	verb: subs. verbo
verdict	verdict: subs. veredicto
verse	verse: subs. verso
version	version: subs. versão
vertically	vertically: adv. verticalmente
vertical	vertical: adj. vertical
vertigo	vertigo: subs. vertigem
very much	very much: adv. muito
very	very: preadv. muito
vessel	vessel: subs. barco
veteran	veteran: subs. veterano
vice president	vice president: subs. vice-presidente
vice-president	vice-president: subs. vice-presidente
vice versa	vice versa: adv. vice-versa
vice	vice: subs. vício
vicinity	vicinity: subs. cercania, vicinity: subs. proximidade
victim	victim: subs. vítima
victory	victory: subs. vitória
video	video: subs. vídeo
viewer	viewer: subs. espectador
view	view: subs. vista, view: ver
vigour	vigour: subs. vigor
village	village: subs. povo
violence	violence: subs. violência
violent	violent: adj. violento
virtually	virtually: adv. virtualmente
virtual	virtual: adj. virtual
virtue	virtue: subs. virtude
virus	virus: subs. vírus, virus: n.ND. vírus
visa	visa: subs. visto
visibility	visibility: subs. visibilidade
visible	visible: adj. visível
visibly	visibly: adv. visivelmente
vision	vision: subs. visão
visitor	visitor: subs. visitante
visit	visit: subs. visita, visit: visitar
visual	visual: adj. visual
vital	vital: adj. vital
vocal	vocal: adj. vocal
vocation	vocation: subs. vocação
voice	voice: subs. voz
volcanic	volcanic: adj. vulcânico
volcano	volcano: subs. vulcão
volume	volume: subs. volume
vote	vote: subs. voto, vote: subs. votação, vote: votar
vowel	vowel: subs. vogal
vs	vs: adv. na contramão
vulnerable	vulnerable: adj. vulnerável
wage	wage: subs. salário
wait	wait: aguardar, wait: esperar
wake	wake: acordar
walk	walk: subs. passeio, walk: andar, walk: caminhar
wall	wall: subs. parede, wall: subs. muralha
walnut	walnut: subs. noz
want to	want to: vbmod. querer
want	want: querer
warming	warming: subs. aquecimento, warming: subs. esquentamento
warm	warm: adj.sint. morno, warm: aquecer, warm: animar
warning	warning: subs. advertência, warning: subs. advertência
warn	warn: advertir
warrior	warrior: subs. guerreiro
war	war: subs. guerra
wash	wash: lavar
watchdog	watchdog: subs. vigilante, watchdog: subs. segurança
watch	watch: subs. relógio, watch: olhar, watch: policiar, watch: vigiar
water	water: subs. água
wave	wave: subs. onda, wave: agitar
way	way: subs. caminho, way: subs. maneira, way: n.sg. maneira, way: n.sg. modo
weakness	weakness: subs. debilidade
weak	weak: adj.sint. débil
wealth	wealth: subs. riqueza
wealthy	wealthy: adj.sint. rico
weapon	weapon: n.sg. arma, weapon: n.pl. arma
wear	wear: trazer
weather	weather: subs. tempo, weather: n.ND. tempo, weather: n.ND. tempo
web	web: subs. teia de aranha, web: subs. site, web: subs. web
wedding	wedding: subs. casamento, wedding: subs. casamento, wedding: subs. casamento
wednesday	Wednesday: subs. quarta-feira, Wednesday: n.ND. quarta-feira, Wednesday: n.ND. quarta-feira
week in week out	week in week out: adv. continuamente
weekly	weekly: adj. semanal, weekly: adv. semanalmente
week	week: subs. semana
weep	weep: chorar
weight	weight: subs. peso
weigh	weigh: pesar
weird	weird: adj. estranho
welfare	welfare: subs. bem-estar
well	well: adv. bem
western	western: adj. ocidental
west	west: subs. oeste
wet	wet: adj. húmido
whatever	whatever: det.ind. qualquer
what	what: prn.itg.m.sp. que
wheat	wheat: subs. trigo
wheel	wheel: subs. volante
when	when: adv. quando
where	where: rel. onde, where: adv. aonde, where: adv. onde
whether	whether: cnjadv. se
which one	which one: prn.itg.m.sg. qual
which	which: prn.itg.m.sp. qual, which: rel. que, which: rel.nn.mf.sp. o qual, which: rel.nn.mf.sp. o que
while	while: subs. momento, while: cnjadv. enquanto
white	white: subs. alvo, white: adj.sint. branco
wholesale	wholesale: adv. por atacado
whole	whole: subs. totalidade, whole: adj. inteiro
wholly	wholly: adv. completamente
whom	whom: rel.asubs. quem
who	who: prn.itg.m. quem, who: rel. que, who: rel.asubs. quem
why	why: adv. por que
widely	widely: adv. amplamente
wide	wide: adj.sint. largo, wide: adj.sint. largo, wide: adj.sint. largo, wide: adj.sint. largo, wide: adj.sint. largo, wide: adj.sint. largo, wide: adj.sint. amplo
widower	widower: subs. viúvo
width	width: subs. largura
wife	wife: subs. mulher
wild	wild: adj.sint. selvagem
willingness	willingness: n.sg. disposição
will	will: subs. vontade
window	window: subs. janela
wind	wind: subs. vento
wine	wine: subs. vinho
wing	wing: subs. ala, wing: subs. asa
winner	winner: subs. ganhador
winter	winter: subs. inverno
win	win: ganhar
wire	wire: subs. fio, wire: subs. cabo
wisdom	wisdom: subs. sensatez
wise	wise: adj.sint. sensato, wise: adj.sint. sábio
wish	wish: subs. desejo, wish: desejar
withdrawal	withdrawal: subs. retirada
withdraw	withdraw: retirar
with impunity	with impunity: adv. impunemente
within reason	within reason: adv. razoavelmente
within	within: adv. adentro, within: adv. dentro
without rhyme or reason	without rhyme or reason: adv. à toa
without	without: pr. sem
with	with: pr. com
witless	witless: adj. curto
witness	witness: subs. testemunha
wit	wit: subs. talento
woman	woman: subs. mulher
wonderful	wonderful: adj. maravilhoso
wonder	wonder: subs. maravilha
wood	wood: n.sg. bosque, wood: n.pl. bosque, wood: n.sg. madeira
word	word: subs. palavra
worker	worker: subs. trabalhador
work out	work out: sair
workshop	workshop: subs. oficina
work	work: subs. lida, work: subs. trabalho, work: subs. obra, work: funcionar, work: trabalhar
world-wide	world-wide: adj. mundial
world	world: subs. mundo, world: adj. mundial
worm	worm: subs. verme
worrisome	worrisome: adj. preocupante
worry	worry: subs. preocupação, worry: preocupar
worsen	worsen: piorar
worthwhile	worthwhile: adj. interessante
worth	worth: subs. valor
worthy	worthy: adj. digno
wound	wound: subs. ferimento
wrap	wrap: envolver
writer	writer: subs. escritor
write	write: escrever
writing	writing: subs. escrita, writing: subs. escritura, writing: subs. escrito, writing: subs. redacção, writing: subs. redação
wrong	wrong: adv. mal
xenophobia	xenophobia: subs. xenofobia
yard	yard: subs. pátio, yard: subs. quintal
year after year	year after year: adv. ano após ano
year in year out	year in year out: adv. ano após ano
year in, year out	year in, year out: adv. ano após ano
yearly	yearly: adj. anual
year	year: subs. ano
yellow	yellow: adj.sint. amarelo
yesterday	yesterday: adv. ontem
yes	yes: adv. sim
yet	yet: cnjadv. mesmo assim, yet: adv. ainda, yet: adv. mesmo
yield	yield: subs. colheita
youngster	youngster: subs. jovem
young	young: adj.sint. jovem
yours	yours: adj. teu, yours: prsubs. o teu, yours: prn.pos.mf.sp. o vosso, yours: prn.pos. o vosso
your	your: det.pos.sp. o vosso, your: det. o vosso, your: det. vosso, your: det. o teu, your: det. teu
youth	youth: subs. juventude
zone	zone: subs. zona, zone: qualificar
