abaixo	abaixo: adv. down, abaixo: adv. low, abaixo: adv. quietly
abalar	abalar: shake
abandonar	abandonar: abandon
abarcar	abarcar: range
abençoar	abençoar: bless
abertamente	abertamente: adv. openly
abertura	abertura: n. opening
abismo	abismo: n. abyss
abóbada	abóbada: n. turn
aborrecimento	aborrecimento: n. aversion
abortar	abortar: abort
aborto	aborto: n. abortion
abraço	abraço: n.m. embrace
abranger	abranger: comprise
abril	abril: n. April
abrir	abrir: open
absentismo	absentismo: n. absenteeism
absolutamente	absolutamente: adv. absolutely, absolutamente: adv. utterly
absoluto	absoluto: adj. absolute
absorver	absorver: absorb
abstenção	abstenção: n. abstention
abstração	abstração: n. abstraction
abstracção	abstracção: n. abstraction
absurdo	absurdo: adj. absurd
abundância	abundância: n. abundance, abundância: n. plenty
abundante	abundante: adj. abundant
abuso	abuso: n. abuse, abuso: n. misuse
acabar	acabar: end, acabar: finish, acabar: round off
académico	académico: adj. academic
acadêmico	acadêmico: adj. academic
acalmar	acalmar: calm
acampamento	acampamento: n. camp
acampar	acampar: camp
acanhado	acanhado: adj. shy
ação	ação: n. action
acariciar	acariciar: stroke
acarretar	acarretar: involve
acção	acção: n. action
accionista	accionista: n. shareholder, accionista: n. stockholder
aceder	aceder: access
aceitação	aceitação: n. acceptance
aceitar	aceitar: accept
aceitável	aceitável: adj. acceptable
aceleração	aceleração: n. acceleration
acelerar	acelerar: race, acelerar: speed
acender	acender: light
acento	acento: n. accent
acentuar	acentuar: stress
acertar	acertar: hit
acesso	acesso: n. access
achar	achar: find
acidentalmente	acidentalmente: adv. accidentally
acidente	acidente: n. accident, acidente: n. crash
acima	acima: adv. above, acima: adv. aloft, acima: adv. on top, acima: adv. up, acima: adv. upward
acima de	acima de: pr. above
acionista	acionista: n. shareholder
aço	aço: n. steel
acolá	acolá: adv. there
acolher	acolher: receive
acomodar	acomodar: accommodate
acompanhante	acompanhante: n. accompanier
acompanhar	acompanhar: accompany
aconselhar	aconselhar: advise, aconselhar: counsel
aconselhável	aconselhável: adj. advisable, aconselhável: adj. advisory
acontecer	acontecer: become
acontecimento	acontecimento: n. event
a contragosto	a contragosto: adv. unwillingly
acordar	acordar: arouse, acordar: awaken, acordar: wake
acordo	acordo: n. accord, acordo: n. agreement, acordo: n. arrangement, acordo: n. chord
acreditar	acreditar: believe, acreditar: think
acrescentar	acrescentar: add
activamente	activamente: adv. actively
activar	activar: actuate
actividade	actividade: n. activity
activo	activo: adj. active
acto	acto: n.m. act
actor	actor: n. actor
actuação	actuação: n. gig, actuação: n. performance
actual	actual: adj. current, actual: adj. ongoing, actual: adj. up-to-date
actualidade	actualidade: n. actuality
actualizar	actualizar: update
actualmente	actualmente: adv. at present, actualmente: adv. currently
actuar	actuar: act, actuar: perform
açúcar	açúcar: n. sugar
acumular	acumular: accumulate
acusação	acusação: n. indictment
acusar	acusar: accuse
adaptação	adaptação: n. adaptation
adaptar	adaptar: adapt, adaptar: suit
ademais	ademais: adv. additionally, ademais: adv. besides, ademais: adv. furthermore, ademais: adv. in addition, ademais: adv. into the bargain, ademais: adv. moreover, ademais: adv. there again
adentro	adentro: adv. within
adequadamente	adequadamente: adv. adequately, adequadamente: adv. properly
adesão	adesão: n. adhesion
adeus	adeus: ij. goodbye
adiantar	adiantar: advance
adiante	adiante: adv. ahead, adiante: adv. forth, adiante: adv. forward
adiante de	adiante de: pr. in front of
adiar	adiar: postpone
adicional	adicional: adj. additional
adicionalmente	adicionalmente: adv. incidentally
adicto	adicto: n.mf. addict
adivinhar	adivinhar: guess
adjacente	adjacente: adj. adjacent
adjectivo	adjectivo: n. adjective
adjetivo	adjetivo: n. adjective
administração	administração: n. administration, administração: n. dispensation, administração: n. management
administrador	administrador: n. administrator
administrar	administrar: administer
administrativo	administrativo: adj. administrative
admiração	admiração: n. admiration
admirar	admirar: admire
admitir	admitir: admit, admitir: allow, admitir: concede
adoção	adoção: n. adoption
adolescente	adolescente: n. teenager
adopção	adopção: n. adoption
adoptar	adoptar: adopt
adoptivo	adoptivo: adj. adoptive, adoptivo: adj. foster
adotar	adotar: adopt
adotivo	adotivo: adj. adoptive
adquirir	adquirir: acquire, adquirir: purchase
adultério	adultério: n. adultery
adulto	adulto: n. adult
adversário	adversário: n. opponent
advertência	advertência: n. warning, advertência: n.f. warning
advertir	advertir: warn
advogado	advogado: n. attorney, advogado: n. lawyer, advogado: n. solicitor
aéreo	aéreo: adj. aerial
aeroporto	aeroporto: n. airport
afectar	afectar: affect
afetar	afetar: affect
aficionado	aficionado: n. amateur
a fim de que	a fim de que: cnjadv. so that
afinal	afinal: adv. finally
afinal de contas	afinal de contas: adv. ultimately
afirmação	afirmação: n. affirmation
afirmar	afirmar: affirm, afirmar: claim
afora	afora: adv. out, afora: adv. outside
afortunado	afortunado: adj. fortunate, afortunado: adj. lucky
africano	africano: adj. African
agência	agência: n. agency, agência: n. bureau
agenda	agenda: n. diary
agente	agente: n. agent, agente: n. officer
agir	agir: act
agitar	agitar: agitate, agitar: wave
agora	agora: adv. now
agosto	agosto: n. August
agradar	agradar: like
agradável	agradável: adj.mf. pleasant
agrário	agrário: adj. agrarian
agravar	agravar: aggravate
agressão	agressão: n. assault
agressivo	agressivo: adj. aggressive
agrícola	agrícola: adj. agricultural
agricultor	agricultor: n. agriculturalist
agricultura	agricultura: n. agriculture, agricultura: n. farming
agrupação	agrupação: n. grouping
agrupamento	agrupamento: n.m. grouping
água	água: n. water
aguardar	aguardar: expect, aguardar: hope, aguardar: wait
agudo	agudo: adj. acute, agudo: adj. sharp
agüentar	agüentar: bear
aguentar	aguentar: bear, aguentar: hold, aguentar: stand
águia	águia: n. eagle
a guisa de	a guisa de: pr. as a
agulha	agulha: n.f. needle
aí	aí: adv. here
ainda	ainda: adv. still, ainda: adv. yet
ainda que	ainda que: cnjadv. although, ainda que: cnjadv. though
a internet	a internet: n. internet, a internet: n. internet
ajuda	ajuda: n.f. aid, ajuda: n.f. help
ajudar	ajudar: help
ajustar	ajustar: adjust
ala	ala: n. wing
alabar	alabar: praise
alarme	alarme: n.m. alarm
álbum	álbum: n. album
alcançar	alcançar: achieve, alcançar: get, alcançar: manage
alcance	alcance: n. extent, alcance: n. range, alcance: n. scope
álcool	álcool: n. alcohol, álcool: n. spirit
alegação	alegação: n. allegation
alegar	alegar: adduce, alegar: allege
alegrar	alegrar: cheer, alegrar: gladden
alegremente	alegremente: adv. breezily, alegremente: adv. cheerfully
alegria	alegria: n.f. joy
além	além: adv. besides
alemão	alemão: n. German, alemão: adj. German
além de	além de: pr. in addition to
algo	algo: prn.tn.nt.sg. anything, algo: prn.tn.nt.sg. something
alguém	alguém: prn. anybody, alguém: prn. anyone, alguém: prn. somebody, alguém: prn. someone
algum	algum: det. any, algum: det. some, algum: det. some, algum: prn. any, algum: prn. some
alheio	alheio: adj. extraneous
aliado	aliado: n. ally
ali	ali: adv. out there, ali: adv. over there
alimentar	alimentar: adj.mf. alimentary, alimentar: adj.mf. food, alimentar: feed
alimentário	alimentário: adj. alimentary, alimentário: adj. food
aliviar	aliviar: ease
alma	alma: n. soul
almoço	almoço: n. breakfast
alojamento	alojamento: n. accommodation, alojamento: n. housing
alpino	alpino: adj. alpine
altamente	altamente: adv. highly
altar	altar: n. altar
alteração	alteração: n. alteration
alterar	alterar: alter
alternativo	alternativo: adj. alternative
altitude	altitude: n. altitude
alto	alto: adj. high, alto: adj. tall
altura	altura: n. altitude
alugar	alugar: rent
alumiar	alumiar: light
aluno	aluno: n.m.sg. pupil, aluno: n.f.sg. pupil, aluno: n.GD.pl. pupil, aluno: n.m.pl. pupil, aluno: n.f.pl. pupil, aluno: n.m.sg. pupil, aluno: n.f.sg. pupil, aluno: n.m.pl. pupil, aluno: n.f.pl. pupil, aluno: n.GD.pl. pupil, aluno: n.m.sg. student, aluno: n.f.sg. student, aluno: n.m.pl. student, aluno: n.f.pl. student, aluno: n.m.sg. student, aluno: n.f.sg. student, aluno: n.m.pl. student, aluno: n.f.pl. student
alusão	alusão: n. allusion
alvo	alvo: n. target, alvo: n. white
amaldiçoar	amaldiçoar: curse
amanhã	amanhã: adv. tomorrow
amante	amante: n. lover
amar	amar: love
amarelo	amarelo: adj. yellow
amargo	amargo: adj. bitter
amargura	amargura: n. bitterness
amável	amável: adj. kind
amavelmente	amavelmente: adv. in kind, amavelmente: adv. kindly, amavelmente: adv. nicely
ambição	ambição: n. ambition
ambicioso	ambicioso: adj. ambitious
ambiental	ambiental: adj. environmental
âmbito	âmbito: n. domain, âmbito: n. field
ambos	ambos: prn. both
ambos os	ambos os: prn. both
ameaça	ameaça: n. threat
ameaçar	ameaçar: loom
americano	americano: n. American, americano: adj. American
amigo	amigo: n. friend
amistoso	amistoso: adj. friendly
amizade	amizade: n. friendship
amo	amo: n.m. landlord
amor	amor: n. love
amostra	amostra: n. sample
amplamente	amplamente: adv. widely
ampliação	ampliação: n. extension
ampliar	ampliar: broaden
amplitude	amplitude: n. amplitude
amplo	amplo: adj. wide
analisar	analisar: analyse, analisar: analyze
análise	análise: n.f.ND. analysis, análise: n.f.sg. analysis, análise: n.f.pl. analysis
anarquista	anarquista: n. anarchist
andamento	andamento: n.m. gear, andamento: n.m. march
andar	andar: n. flat, andar: n. floor, andar: walk
anel	anel: n. ring
anfitrião	anfitrião: n. host
ângulo	ângulo: n. angle
angústia	angústia: n. anxiety
animação	animação: n. animation
animal	animal: n. animal
animar	animar: encourage, animar: warm
aniversário	aniversário: n.m. anniversary, aniversário: n.m. birthday, aniversário: n. birthday
anjo	anjo: n. angel
ano	ano: n. year
ano após ano	ano após ano: adv. from year to year, ano após ano: adv. year after year, ano após ano: adv. year in, year out, ano após ano: adv. year in year out
anonimato	anonimato: n. anonymity
anónimo	anónimo: adj. anonymous
anônimo	anônimo: adj. anonymous
anotar	anotar: note
ânsia	ânsia: n. anxiety, ânsia: n. eagerness
ansiedade	ansiedade: n. anxiety
ansioso	ansioso: adj. anxious
ante	ante: pr. before, ante: pr. in front of, ante: adv. in front
antepassado	antepassado: n. ancestor
anterior	anterior: adj. former, anterior: adj. previous
anteriormente	anteriormente: adv. formerly, anteriormente: adv. previously
antes	antes: adv. before
antes de mais nada	antes de mais nada: adv. before everything, antes de mais nada: adv. before everything else
antigo	antigo: adj. ancient, antigo: adj. antique
antiquado	antiquado: adj. old-fashioned
anual	anual: adj. annual, anual: adj. yearly
anualmente	anualmente: adv. annually
anunciar	anunciar: advertise, anunciar: announce
anúncio	anúncio: n. ad, anúncio: n. advertisement, anúncio: n. announcement, anúncio: n. commercial, anúncio: n. notice
ânus	ânus: n.m.sp. anus, ânus: n.m.sp. anus
ao arredor	ao arredor: adv. around
ao invés de	ao invés de: pr. instead of
ao mesmo tempo	ao mesmo tempo: adv. at a time, ao mesmo tempo: adv. at the same time
aonde	aonde: adv. where
ao redor	ao redor: adv. around
ao todo	ao todo: adv. altogether, ao todo: adv. in total, ao todo: adv. taken altogether
apagar	apagar: erase, apagar: turn off
apanhar	apanhar: trap
aparecer	aparecer: appear, aparecer: show up, aparecer: turn up
aparelho	aparelho: n. device
aparência	aparência: n. appearance
aparente	aparente: adj. apparent
aparentemente	aparentemente: adv. apparently, aparentemente: adv. seemingly
apartamento	apartamento: n. apartment
aparte	aparte: adv. apart
apelação	apelação: n. appeal
apelar	apelar: appeal
apelo	apelo: n.m. call
apenas	apenas: adv. only
apertar	apertar: tighten
apesar que	apesar que: cnjadv. although
aplaudir	aplaudir: applaud
aplauso	aplauso: n. applause, aplauso: n. clap
aplicação	aplicação: n. application
aplicar	aplicar: apply, aplicar: enforce
apoiar	apoiar: lean
apoio	apoio: n. stand, apoio: n. support
apontar	apontar: aim, apontar: point, apontar: prompt, apontar: target
aposentação	aposentação: n. retirement
aposentadoria	aposentadoria: n. retirement
apostar	apostar: bet
apreciar	apreciar: appreciate
apreender	apreender: confiscate
aprender	aprender: learn
aprendizagem	aprendizagem: n.f. learning
apresentação	apresentação: n. presentation
apresentar	apresentar: feature, apresentar: introduce, apresentar: present
a priori	a priori: adv. a priori
aprofundar	aprofundar: deepen
aprovação	aprovação: n. approval
aprovar	aprovar: approve, aprovar: endorse, aprovar: pass
aproveitar	aproveitar: take advantage of
aproximação	aproximação: n. approach, aproximação: n. approximation
aproximadamente	aproximadamente: adv. about, aproximadamente: adv. approximately, aproximadamente: adv. roughly
aproximar	aproximar: approximate
apto	apto: adj.m.sg. apt, apto: adj.f.sg. apt, apto: adj.m.pl. apt, apto: adj.f.pl. apt, apto: adj.GD.pl. apt, apto: adj. apt, apto: adj. fit
aquecer	aquecer: heat, aquecer: warm
aquecimento	aquecimento: n. warming
aquele	aquele: det. that, aquele: det. that, aquele: prn. that, aquele: prn. that
aqui	aqui: adv. here
aquilo	aquilo: prn. that
aquisição	aquisição: n. acquisition
árabe	árabe: adj. Arab
aranha	aranha: n. spider
arar	arar: plough
ar	ar: n. air
árbitro	árbitro: n. referee
arcebispo	arcebispo: n. archbishop
arco	arco: n. arch
ardente	ardente: adj. burning
arder	arder: burn
área	área: n. area
areia	areia: n. sand
a respeito de	a respeito de: pr. about, a respeito de: pr. on
argentino	argentino: adj. Argentine
argumentar	argumentar: argue
argumento	argumento: n. argument
arma	arma: n. arm, arma: n. weapon, arma: n. weapon
armadilha	armadilha: n.f. trap, armadilha: n. trap
armadura	armadura: n. armour
armamento	armamento: n. armament
armar	armar: arm
armazenar	armazenar: store
aroma	aroma: n.m. aroma
arqueológico	arqueológico: adj. archaeologic
arquitecto	arquitecto: n.m.sg. architect, arquitecto: n.f.sg. architect, arquitecto: n.GD.pl. architect, arquitecto: n.m.pl. architect, arquitecto: n.f.pl. architect, arquitecto: n.m.sg. architect, arquitecto: n.f.sg. architect, arquitecto: n.m.pl. architect, arquitecto: n.f.pl. architect, arquitecto: n.GD.pl. architect
arquitectura	arquitectura: n. architecture
arquiteto	arquiteto: n.m.sg. architect, arquiteto: n.f.sg. architect, arquiteto: n.m.pl. architect, arquiteto: n.f.pl. architect, arquiteto: n.m.sg. architect, arquiteto: n.f.sg. architect, arquiteto: n.m.pl. architect, arquiteto: n.f.pl. architect
arquivo	arquivo: n. file, arquivo: n. archive
arranjar	arranjar: fix
arranjo	arranjo: n. arrangement
arranque	arranque: n.m. start
arrastar	arrastar: drag
arrebato	arrebato: n. rage
arrecadação	arrecadação: n. collection
arrecadar	arrecadar: collect
arredor	arredor: adv. around
arrendamento	arrendamento: n. lease
arrendar	arrendar: lease
arriba	arriba: adv. above
arrojar	arrojar: launch
arsenal	arsenal: n. arsenal
arte	arte: n.f. art
artefacto	artefacto: n. artifact
artefato	artefato: n. artifact
artesanato	artesanato: n. handicraft
artesão	artesão: n. artisan
articular	articular: articulate
artificial	artificial: adj. artificial
artigo	artigo: n. article, artigo: n. paper
artista	artista: n. artist, artista: n. entertainer
artístico	artístico: adj. artistic
árvore	árvore: n.f. tree
asa	asa: n. wing
às cegas	às cegas: adv. sight unseen
ascender	ascender: climb
ascensão	ascensão: n.f. promotion
asco	asco: n. disgust
asfixiar	asfixiar: suffocate
asiático	asiático: n. Asian, asiático: adj. Asian
asilo	asilo: n. asylum
asno	asno: n. ass
aspecto	aspecto: n. appearance, aspecto: n. aspect, aspecto: n. look
áspero	áspero: adj. rough
assalto	assalto: n. round
assassinato	assassinato: n. killing, assassinato: n. murder
assassino	assassino: n. murderer
assegurar	assegurar: ensure, assegurar: insure, assegurar: secure
assembleia	assembleia: n. assembly
assembléia	assembléia: n. assembly
assento	assento: n. seat
assim	assim: adv. like this, assim: adv. thereby, assim: adv. thus
assim mesmo	assim mesmo: adv. likewise
assinalar	assinalar: point, assinalar: signal
assinar	assinar: sign
assinatura	assinatura: n. signature, assinatura: n. subscription, assinatura: n. signature
assistência	assistência: n. assistance
assistente	assistente: n. assistant
assistir	assistir: assist
associação	associação: n. association
assomar	assomar: aim, assomar: prompt
assombrar	assombrar: surprise
assombro	assombro: n.m. surprise
assombrosamente	assombrosamente: adv. surprisingly
assumir	assumir: assume
assunto	assunto: n. affair, assunto: n. issue, assunto: n. matter, assunto: n. subject
assustar	assustar: frighten, assustar: scare
astronauta	astronauta: n. astronaut
astrónomo	astrónomo: n. astronomer
astrônomo	astrônomo: n. astronomer
astuto	astuto: adj. cunning
as vezes	as vezes: adv. sometimes
às vezes	às vezes: adv. sometimes
atacante	atacante: n. attacker
atacar	atacar: attack, atacar: strike
atadura	atadura: n.f. ligament
ataque	ataque: n. attack, ataque: n. stroke
atar	atar: bind, atar: tie
até	até: pr. until, até: pr. up to
até mesmo	até mesmo: adv. even
atenção	atenção: n. attention
atenciosamente	atenciosamente: adv. attentively
atender	atender: attend
atendimento	atendimento: n.m. attention
atentado	atentado: n. attack, atentado: n. attempt
atentamente	atentamente: adv. attentively
atentar	atentar: attack
atento	atento: adj. attentive
aterrizar	aterrizar: land
atingir	atingir: achieve, atingir: get, atingir: manage
atitude	atitude: n. attitude
ativamente	ativamente: adv. actively
ativar	ativar: actuate
atividade	atividade: n. activity
ativo	ativo: adj. active
atleta	atleta: n. athlete
atletismo	atletismo: n. athletics
à toa	à toa: adv. without rhyme or reason
ato	ato: n.m. act
atómico	atómico: adj. atomic
atômico	atômico: adj. atomic
ator	ator: n. actor
a torto e a direito	a torto e a direito: adv. indiscriminately
atração	atração: n. attraction, atração: n. pull
atractivo	atractivo: n. appeal, atractivo: adj. attractive
atraente	atraente: adj.mf. attractive
atraiçoar	atraiçoar: betray
atrair	atrair: attract
atrapar	atrapar: trap
atrasar	atrasar: delay, atrasar: retard
atrás	atrás: adv. back, atrás: adv. backwards
atraso	atraso: n. delay
atrativo	atrativo: n. appeal
atribuir	atribuir: assign, atribuir: attribute
atuação	atuação: n. performance
atual	atual: adj. current
atualidade	atualidade: n. actuality
atualmente	atualmente: adv. at present
audaz	audaz: adj.mf.pl. audacious, audaz: adj.mf.sg. audacious
audiência	audiência: n. audience, audiência: n. hearing
audiovisual	audiovisual: adj. audiovisual
auditório	auditório: n. auditorium
aumentar	aumentar: boost, aumentar: increase, aumentar: raise, aumentar: rise
aumento	aumento: n. increase, aumento: n. rise
ausência	ausência: n. absence
ausente	ausente: adj. absent
australiano	australiano: adj. Australian
austríaco	austríaco: adj. Austrian
autêntico	autêntico: adj. authentic
auto	auto: n.m.sg. act, auto: n.m.pl. performance
autocarro	autocarro: n.m. coach
automaticamente	automaticamente: adv. automatically
automático	automático: adj. automatic
automóvel	automóvel: n. car
autonómico	autonómico: adj. autonomic
autonômico	autonômico: adj. autonomic
autónomo	autónomo: adj. autonomous
autônomo	autônomo: adj. autonomous
autópsia	autópsia: n. autopsy
autor	autor: n. author
autoridade	autoridade: n. authority
autorizar	autorizar: authorize, autorizar: entitle
aval	aval: n. guarantee
avaliação	avaliação: n. evaluation
avaliar	avaliar: assess, avaliar: evaluate
avariar	avariar: break
avenida	avenida: n. avenue
aventura	aventura: n. adventure, aventura: n. venture
aversão	aversão: n. aversion, aversão: n. dislike, aversão: n. hatred
aviação	aviação: n. aviation
avião	avião: n. aircraft, avião: n. airplane, avião: n. plane
avô	avô: n. grandfather, avô: n. grandfather, avô: n. grandmother, avô: n. grandparent, avô: n. grandparent
azarado	azarado: adj. miserable
azeite	azeite: n. oil
azul	azul: adj.mf. blue
bactéria	bactéria: n.f. bacterium
bagagem	bagagem: n.f. baggage, bagagem: n.f. luggage
baía	baía: n. bay
bailarino	bailarino: n. dancer
bairro	bairro: n. neighbourhood, bairro: n. quarter
baixar	baixar: go down
baixo	baixo: adj. low, baixo: adj. short, baixo: adv. under
bala	bala: n. bullet
balanço	balanço: n. balance
balão	balão: n.m.ND. globe, balão: n.m.pl. globe, balão: n.m.sg. globe
balear	balear: adj. Balearic
balir	balir: bleat
banco	banco: n. bank
banda	banda: n. band, banda: n. strip
bandeira	bandeira: n. flag
banqueiro	banqueiro: n. banker
banquete	banquete: n. banquet
baptizar	baptizar: baptize, baptizar: dub
baralhar	baralhar: stir
barato	barato: adj. cheap
barba	barba: n. beard
bar	bar: n. bar
barbear	barbear: shave
barca	barca: n. boat
barco	barco: n. ship, barco: n. vessel
barra	barra: n. bar, barra: n. rail
barranco	barranco: n. ravine
barreira	barreira: n. barrier
barril	barril: n. drum
basear	basear: base
base	base: n. base, base: n. basis
basebol	basebol: n. baseball
basicamente	basicamente: adv. basically
básico	básico: adj. basic
basílica	basílica: n. basilica
basquete	basquete: n. basketball
basquetebol	basquetebol: n. basketball
bastante	bastante: adv. enough, bastante: adv. quite a lot, bastante: adv. rather
bastar	bastar: suffice
batalha	batalha: n. battle
batalhão	batalhão: n. batallion
bater	bater: beat
batizar	batizar: baptize
bêbado	bêbado: n. drunkard
beber	beber: drink
bebida	bebida: n. drink
beijo	beijo: n. kiss
beisebol	beisebol: n. baseball
beleza	beleza: n. beauty
belo	belo: adj. beautiful
bem	bem: n. good, bem: adv. all right, bem: adv. alright, bem: adv. fine, bem: adv. good, bem: adv. right, bem: adv. well
bem-estar	bem-estar: n. welfare
bem mais	bem mais: adv. all the more, bem mais: adv. much longer, bem mais: adv. much more
bem na frente	bem na frente: adv. right in front
bênção	bênção: n. blessing
beneficiar	beneficiar: benefit
benefício	benefício: n. benefit, benefício: n. gain, benefício: n. profit
bengala	bengala: n.f. clave
berço	berço: n.m. cradle, berço: n. dock
bíblico	bíblico: adj. biblical
biblioteca	biblioteca: n. library
bibliotecário	bibliotecário: n. librarian
bicha	bicha: n. rank, bicha: n. row, bicha: n.f. tail
bico	bico: n. beak
bilateral	bilateral: adj. bilateral
bilhete	bilhete: n. note, bilhete: n.m. passage, bilhete: n. ticket
bilião	bilião: n. trillion
biológico	biológico: adj. biological
bispo	bispo: n. bishop
blindar	blindar: armour
bloco	bloco: n. block
boato	boato: n.m. rumble
bobagem	bobagem: n. foolishness
boca	boca: n. mouth
bochecha	bochecha: n. cheek
boicote	boicote: n. boycott
bola	bola: n.f. balloon, bola: n.f. bowl
boliviano	boliviano: adj. Bolivian
bolsa	bolsa: n.f. bag, bolsa: n. grant, bolsa: n. scholarship
bomba	bomba: n. bomb, bomba: n. pump
bombardear	bombardear: bomb
bombardeio	bombardeio: n. bombardment
bom	bom: adj. fine, bom: adj.m.sg. good, bom: adj. good
bondade	bondade: n. goodness, bondade: n. kindness
boneco	boneco: n.f. doll
bonito	bonito: adj. beautiful, bonito: adj. pretty
borbulha	borbulha: n. bubble
borracha	borracha: n. rubber
bosque	bosque: n. forest, bosque: n. wood, bosque: n. wood
botão	botão: n. button
botim	botim: n. booty
boxe	boxe: n.m. boxing
braço	braço: n. arm, braço: n. arm
branco	branco: adj. white
brando	brando: adj. soft
brasileiro	brasileiro: adj. Brazilian
breve	breve: adj. brief
brilhante	brilhante: adj. bright, brilhante: adj. brilliant
brilhar	brilhar: shine
brinquedo	brinquedo: n.m. toy
britânico	britânico: n. British, britânico: adj. British
brutal	brutal: adj. brutal
brutalmente	brutalmente: adv. brutally
bruto	bruto: adj. dirty
buraco	buraco: n. hole
burrice	burrice: n. stupidity
busca	busca: n. pursuit, busca: n. research, busca: n. search
buscar	buscar: look for
cabalmente	cabalmente: adv. totally
cabeça	cabeça: n.f. boss, cabeça: n.f. cape, cabeça: n.f. head
cabelo	cabelo: n. hair
caber	caber: fit
cabo	cabo: n.m. boss, cabo: n. cable, cabo: n.m. cape, cabo: n. handle, cabo: n.m. head, cabo: n. wire
cá	cá: adv. here
caçoar	caçoar: kid
cada	cada: det. each, cada: det. every
cadeia	cadeia: n. chain
cadeira	cadeira: n. chair, cadeira: n.f. seat
cadeirão	cadeirão: n.m. armchair, cadeirão: n.m. seat
café	café: n. coffee
cair	cair: fall, cair: fall down
caixa	caixa: n.f. box
calçado	calçado: n. footwear
calcular	calcular: calculate, calcular: estimate, calcular: reckon
cálculo	cálculo: n. calculation
calefação	calefação: n. heating
calefacção	calefacção: n. heating
calendário	calendário: n. calendar
calmo	calmo: adj. calm, calmo: adj. quiet
calor	calor: n.m. heat
cama	cama: n.f. bed
camada	camada: n. layer
câmara	câmara: n. camera
câmbio	câmbio: n.m. change
câmera	câmera: n. camera
caminhão	caminhão: n. lorry, caminhão: n. truck
caminhar	caminhar: walk
caminho	caminho: n. lane, caminho: n. path, caminho: n. way
camisa	camisa: n. shirt
camisola	camisola: n.f. jumper
campanha	campanha: n. campaign
campeão	campeão: n. champion
campeonato	campeonato: n. championship
campo	campo: n. camp, campo: n. countryside, campo: n. field
camponês	camponês: n. peasant
campus	campus: n. campus, campus: n. campus
câmpus	câmpus: n. campus
cana	cana: n. cane
canadense	canadense: n.mf. Canadian, canadense: adj.mf. Canadian
canal	canal: n.m. channel
canção	canção: n. song
cancelar	cancelar: cancel
câncer	câncer: n. cancer
cancro	cancro: n. cancer
candidato	candidato: n. candidate
candidatura	candidatura: n. candidature
caneca	caneca: n. cup
cantar	cantar: sing
canto	canto: n. singing, canto: n. song
cantor	cantor: n.GD. singer, cantor: n.m. singer, cantor: n.f. singer
cão	cão: n. dog
caos	caos: n. chaos, caos: n. chaos
capa	capa: n. coat, capa: n. layer
capacete	capacete: n. helmet
capacidade	capacidade: n. capability, capacidade: n. capacity, capacidade: n. qualification
capaz	capaz: adj.mf.pl. able, capaz: adj.mf.sg. able, capaz: adj.mf.pl. capable, capaz: adj.mf.sg. capable
capital	capital: n.m. capital, capital: n.f. capital, capital: adj. principal
capitalismo	capitalismo: n. capitalism
capitão	capitão: n. captain
capítulo	capítulo: n. chapter
capturar	capturar: capture
cara a cara	cara a cara: adv. face to face
cara	cara: n. face
carácter	carácter: n. character
característica	característica: n. characteristic, característica: n. feature
caracterizar	caracterizar: characterize
caráter	caráter: n. character
caravana	caravana: n. caravan
carbono	carbono: n. carbon
cárcere	cárcere: n.m. prison
cardeal	cardeal: n. cardinal
cardíaco	cardíaco: adj. cardiac
carência	carência: n. lack
careta	careta: n. grimace
carga	carga: n. charge, carga: n. load
cargo	cargo: n. charge, cargo: n. post
caridade	caridade: n. charity
carinhoso	carinhoso: adj. fond
carne	carne: n. flesh, carne: n. meat
caro	caro: adj. expensive
carreira	carreira: n. career, carreira: n. race, carreira: n. racing, carreira: n. run, carreira: n. running
carro	carro: n. auto, carro: n. car
carta	carta: n. card, carta: n. letter, carta: n. menu
cartão	cartão: n.m. card
cartaz	cartaz: n.m. banner, cartaz: n. poster
carteiro	carteiro: n. postman
cartel	cartel: n. poster
carvão	carvão: n. coal
casa	casa: n. home, casa: n. house, casa: n. household
casal	casal: n.m. couple, casal: n. marriage
casamento	casamento: n. wedding, casamento: n.m.pl. wedding, casamento: n.m.sg. wedding
casco	casco: n. helmet
caso	caso: n. case, caso: n. instance, caso: cnjadv. if
castelhano	castelhano: n. Spaniard, castelhano: adj. Spanish
castelo	castelo: n. castle
castigar	castigar: punish
castigo	castigo: n. punishment
casual	casual: adj. casual
catalão	catalão: n. Catalan, catalão: adj. Catalan
catálogo	catálogo: n. catalogue
catarata	catarata: n. cataract
catástrofe	catástrofe: n. catastrophe
cátedra	cátedra: n. chair
catedral	catedral: n. cathedral
cativeiro	cativeiro: n.m. captivity
católico	católico: adj. Catholic
causa	causa: n. cause
causar	causar: cause
cavaleiro	cavaleiro: n.m. rider
cavalo	cavalo: n. horse
cavar	cavar: dig
cedo	cedo: adv. early, cedo: adv. soon
cego	cego: adj. blind
cela	cela: n. cell
celebração	celebração: n. celebration
celebrar	celebrar: celebrate
célebre	célebre: adj. famous
célula	célula: n. cell
cemitério	cemitério: n. cemetery
cena	cena: n. scene
cenário	cenário: n. stage
cenografia	cenografia: n. scenography
censura	censura: n. censorship
centena	centena: n.f. hundred
centímetro	centímetro: n. centimetre
central	central: n. switchboard, central: adj. central, central: adj. centre, central: adj.mf. centrical, central: adj.mf. downtown
centrar	centrar: center, centrar: centre, centrar: focus
centro	centro: n. centre
céptico	céptico: adj. skeptical
cerca de	cerca de: pr. by, cerca de: pr. near
cercania	cercania: n. vicinity
cereal	cereal: n. cereal
cerebral	cerebral: adj. cerebral
cérebro	cérebro: n. brain
cerimónia	cerimónia: n. ceremony
cerimônia	cerimônia: n. ceremony
certeiramente	certeiramente: adv. precisely
certeza	certeza: n. certainty
certificado	certificado: n.m. certificate
certo	certo: det. some, certo: adj.m.sg. correct, certo: adj.f.sg. correct, certo: adj.m.pl. correct, certo: adj.f.pl. correct, certo: adj. correct
cerveja	cerveja: n. beer
cesta	cesta: n. basket
cético	cético: adj. skeptical
céu	céu: n. heaven, céu: n. sky
chá	chá: n. tea
chamar	chamar: call, chamar: shout
chance	chance: n. opportunity
chanceler	chanceler: n.mf. chancellor
chão	chão: n. soil
chateado	chateado: adj. annoying
chave	chave: n.f. key, chave: n.f. nail
chefe	chefe: n.m. boss, chefe: n.f. boss, chefe: n.GD. boss, chefe: n.m. cape, chefe: n.f. cape, chefe: n.GD. cape, chefe: n.GD. chief, chefe: n.f. chief, chefe: n.m. head, chefe: n.f. head, chefe: n.GD. head
chefia	chefia: n. authority
chegada	chegada: n. arrival, chegada: n. finish
chegar	chegar: arrive, chegar: get
cheiamente	cheiamente: adv. fully
cheio	cheio: adj. full
cheirar	cheirar: smell
cheiro	cheiro: n.m. smell
cheque	cheque: n. cheque
chileno	chileno: adj. Chilean
chinês	chinês: adj. Chinese
chip	chip: n. chip
chocar	chocar: bump, chocar: crash
choque	choque: n. crash, choque: n. shock, choque: n. smash
chorar	chorar: cry, chorar: weep
chuva	chuva: n. rain
ciclo	ciclo: n. cycle
cidadania	cidadania: n. citizenship
cidadão	cidadão: n. citizen
cidade	cidade: n. city, cidade: n. town
ciência	ciência: n. science
científico	científico: adj. scientific
cientista	cientista: n.mf. scientist
cifra	cifra: n. figure
cigarro	cigarro: n. cigar, cigarro: n. cigarette
cima	cima: n.f. peak, cima: adv. on
cimeira	cimeira: n.f. peak, cimeira: n. summit
cimo	cimo: n.m. peak
cine	cine: n. cinema
cinematográfico	cinematográfico: adj. cinematographic
cinto	cinto: n. belt
circuito	circuito: n. circuit
circulação	circulação: n. circulation
circular	circular: circulate
círculo	círculo: n. circle, círculo: n. ring
circunstância	circunstância: n. circumstance
citar	citar: cite, citar: quote
ciumento	ciumento: adj. jealous
civil	civil: adj. civil
civilização	civilização: n. civilization
clã	clã: n. clan
claramente	claramente: adv. clearly, claramente: adv. distinctly
clareza	clareza: n. clarity
claridade	claridade: n. clarity
claro	claro: adj. clear, claro: adj. light
classe	classe: n. class, classe: n. classroom, classe: n. kind, classe: n. sort
clássico	clássico: adj. classical
classificação	classificação: n. classification
cláusula	cláusula: n. clause
cliente	cliente: n.mf. client, cliente: n.mf. customer
clima	clima: n. climate
climático	climático: adj. climatic
clique	clique: n. click
clube	clube: n. club
coalizão	coalizão: n. coalition
cobertura	cobertura: n.f. attic, cobertura: n. coverage, cobertura: n. covering
cobrança	cobrança: n.f. collection
cobrar	cobrar: charge, cobrar: earn
cocaína	cocaína: n. cocaine
cocktail	cocktail: n. cocktail
código	código: n. code
coelho	coelho: n. rabbit
coerência	coerência: n. coherence
coesão	coesão: n. cohesion
coincidência	coincidência: n. coincidence
coincidir	coincidir: coincide
coisa	coisa: n. thing
coitado	coitado: adj. miserable
colaboração	colaboração: n. collaboration
colaborador	colaborador: n. collaborator
cola	cola: n.f. glue
colar	colar: hit
colarinho	colarinho: n. neck
coleção	coleção: n. collection
colecção	colecção: n. collection
coleccionar	coleccionar: collect
colecionar	colecionar: collect
colectivo	colectivo: adj. collective
colega	colega: n. colleague, colega: n.mf. companion, colega: n.mf. fellow, colega: n.mf. mate, colega: n.mf. partner
colégio	colégio: n. school
coletivo	coletivo: adj. collective
colheita	colheita: n. crop, colheita: n. harvest, colheita: n. yield
colisão	colisão: n. collision
colmar	colmar: satisfy
colocação	colocação: n. placing
colocar	colocar: dispose, colocar: place, colocar: position
colombiano	colombiano: adj. Colombian
coluna	coluna: n. column
comandante	comandante: n. commander
comando	comando: n. commando, comando: n. driving
combate	combate: n. fight
combater	combater: combat
combinação	combinação: n. combination
combinar	combinar: combine
combinar com	combinar com: meet
comboio	comboio: n. train
combustível	combustível: n. fuel
com	com: pr. with
começar	começar: begin, começar: commence, começar: open, começar: start
começo	começo: n. beginning
comédia	comédia: n. comedy
comentar	comentar: comment
comentário	comentário: n. comment, comentário: n. remark
comentarista	comentarista: n. commentator
comercial	comercial: adj. commercial
comercializar	comercializar: commercialize
comerciante	comerciante: n. dealer, comerciante: n. trader
comércio	comércio: n. commerce, comércio: n. trade, comércio: n. trading
comer	comer: eat, comer: lunch
cometer	cometer: commit
com freqüência	com freqüência: adv. often
comida	comida: n.f. food, comida: n.f. lunch
comissão	comissão: n. commission
comité	comité: n. committee
comitê	comitê: n. committee
como	como: pr. as, como: pr. as a, como: pr. like, como: pr. such as, como: adv. how
comodamente	comodamente: adv. comfortably
comodidade	comodidade: n. comfort, comodidade: n. convenience
cómodo	cómodo: adj. comfortable
cômodo	cômodo: adj. comfortable
compaixão	compaixão: n. compassion, compaixão: n. sympathy
companheiro	companheiro: n. companion, companheiro: n. partner
companhia	companhia: n. company
comparação	comparação: n. comparison
comparar	comparar: compare
compartilhamento	compartilhamento: n. cast, compartilhamento: n. distribution
compartilhar	compartilhar: share
compatriota	compatriota: n. compatriot
compensar	compensar: compensate
competência	competência: n. qualification
competição	competição: n. competition, competição: n. contest
competidor	competidor: n. competitor
competir	competir: compete
competitivo	competitivo: adj. competitive
complementar	complementar: adj.mf. complementary, complementar: complement
completamente	completamente: adv. all the way, completamente: adv. completely, completamente: adv. entirely, completamente: adv. right through, completamente: adv. straight through, completamente: adv. to capacity, completamente: adv. to the ground, completamente: adv. wholly
completar	completar: complete
completo	completo: adj. complete
complexo	complexo: adj. complex
complicação	complicação: n. complication
complicar	complicar: complicate
componente	componente: n. component
compor	compor: compose
comportamento	comportamento: n. behaviour
comportar	comportar: comport
composição	composição: n. composition
compositor	compositor: n. composer
comprador	comprador: n. buyer, comprador: n. purchaser
comprar	comprar: buy
comprazer	comprazer: please
compreender	compreender: comprise
compressão	compressão: n. compression
comprometer	comprometer: engage
compromisso	compromisso: n. commitment, compromisso: n. engagement
computador	computador: n. computer
com respeito a	com respeito a: pr. as regards, com respeito a: pr. regarding
comum	comum: adj.mf. common
comunicação	comunicação: n. communication
comunicado	comunicado: n. communiqué
comunicar	comunicar: communicate
comunidade	comunidade: n. community
comunista	comunista: adj. communist
conceber	conceber: conceive
conceder	conceder: concede, conceder: grant
conceito	conceito: n. concept
conceitual	conceitual: adj. conceptual
concelho	concelho: n. municipality
concentração	concentração: n. concentration
concentrar	concentrar: mass
concepção	concepção: n. conception
conceptual	conceptual: adj. conceptual
concerto	concerto: n. concert, concerto: n. concerto
concluir	concluir: conclude
conclusão	conclusão: n. completion, conclusão: n. conclusion
conclusivamente	conclusivamente: adv. finally
concordar	concordar: agree
concorrência	concorrência: n. competition
concretamente	concretamente: adv. specifically
concreto	concreto: adj. concrete
concurso	concurso: n. contest
conde	conde: n. earl
condenação	condenação: n. conviction
condenar	condenar: condemn, condenar: convict
condição	condição: n. condition
condução	condução: n. driving
conductor	conductor: n.GD. chauffeur, conductor: n. driver
conduta	conduta: n.f. behaviour, conduta: n.f. conduct
conduto	conduto: n. pipe
conduzir	conduzir: conduct, conduzir: drive
conectar	conectar: connect
conexão	conexão: n. connection
conferência	conferência: n. conference, conferência: n. lecture
confiança	confiança: n. confidence, confiança: n. trust
confiar	confiar: entrust, confiar: rely, confiar: trust
confirmar	confirmar: confirm
confiscar	confiscar: confiscate, confiscar: seize
conflito	conflito: n. conflict
conforme	conforme: adv. in agreement, conforme: adv. of like mind
confundir	confundir: confuse
confusão	confusão: n. confusion
confuso	confuso: adj. garbled
congelar	congelar: freeze
congresso	congresso: n. congress
conhecedor	conhecedor: n. connoisseur
conhecer	conhecer: know, conhecer: meet
conhecimento	conhecimento: n. knowledge
conjuntamente	conjuntamente: adv. in conjunction, conjuntamente: adv. jointly
conjunto	conjunto: n. group, conjunto: n. set, conjunto: adj. conjoint
conquista	conquista: n. conquest
conquistar	conquistar: conquer
consagrar	consagrar: consecrate
consecutivo	consecutivo: adj. consecutive
conseguir	conseguir: achieve, conseguir: attain, conseguir: get, conseguir: get hold of, conseguir: manage, conseguir: reach
conselheiro	conselheiro: n. councillor
conselho	conselho: n. advice, conselho: n. council, conselho: n. counsel, conselho: n. tip
consenso	consenso: n. consensus
consentimento	consentimento: n. consent
consequência	consequência: n. consequence
conseqüência	conseqüência: n. consequence
consequente	consequente: adj. consistent
conseqüente	conseqüente: adj. consistent
consertar	consertar: repair
conservação	conservação: n. conservation
conservador	conservador: n. curator, conservador: adj. conservative
conservante	conservante: n. preservative
consideração	consideração: n. consideration, consideração: n. regard
considerar	considerar: consider, considerar: reckon
considerável	considerável: adj. considerable
consideravelmente	consideravelmente: adv. considerably
consignar	consignar: consign
consistir	consistir: consist
consolar	consolar: comfort
consolidar	consolidar: consolidate
consolo	consolo: n. comfort, consolo: n. consolation
consórcio	consórcio: n. consortium
conspiração	conspiração: n. conspiracy
constante	constante: adj. constant
constantemente	constantemente: adv. constantly
constar	constar: feature
constatar	constatar: ascertain
constelação	constelação: n. constellation
constitucional	constitucional: adj. constitutional
constitucionalmente	constitucionalmente: adv. constitutionally
constituição	constituição: n. constitution
constituir	constituir: constitute
construção	construção: n. building, construção: n. construction
construir	construir: build, construir: construct
construtor	construtor: n. builder, construtor: n. constructor
consulta	consulta: n. consultation, consulta: n. enquiry, consulta: n. inquiry, consulta: n. query
consultar	consultar: consult
consumar	consumar: consummate
consumidor	consumidor: n. consumer
consumir	consumir: consume
consumo	consumo: n. consumption
contabilidade	contabilidade: n. accountancy, contabilidade: n. accounting
conta	conta: n.f. account
contactar	contactar: contact
contacto	contacto: n. contact
contagem	contagem: n.f. account
contaminação	contaminação: n. pollution
contaminar	contaminar: pollute
contanto que	contanto que: cnjadv. in order that
contar	contar: count
contatar	contatar: contact
contato	contato: n. contact
contemplar	contemplar: contemplate
contemporâneo	contemporâneo: adj. contemporary
contenda	contenda: n. contention
contentar	contentar: content
contente	contente: adj.mf. happy
conter	conter: contain
contestar	contestar: answer
conteúdo	conteúdo: n. content
contexto	contexto: n. context
continental	continental: adj. continental
continente	continente: n. continent
contingente	contingente: n. contingent
continuação	continuação: n. continuation
continuamente	continuamente: adv. continually, continuamente: adv. continuously, continuamente: adv. every now and again, continuamente: adv. week in week out
continuar	continuar: continue, continuar: go on, continuar: keep, continuar: keep on
continuidade	continuidade: n. continuity
contínuo	contínuo: adj. continuous
conto	conto: n. tale
contra	contra: pr. against
contradição	contradição: n. contradiction
contradizer	contradizer: contradict
contrair	contrair: contract
contrário	contrário: adj. contrary
contrastar	contrastar: contrast
contratar	contratar: hire, contratar: hire out
contrato	contrato: n. agreement, contrato: n. contract
contribuição	contribuição: n. contribution
contribuinte	contribuinte: n. taxpayer
contribuir	contribuir: contribute
contributo	contributo: n.m. contribution
controlar	controlar: control, controlar: monitor
controle	controle: n. check, controle: n. control, controle: n. hold, controle: n. monitoring, controle: n. regulation
contudo	contudo: cnjcoo. but
convenção	convenção: n. convention
convencer	convencer: convince
conveniente	conveniente: adj. convenient
convênio	convênio: n. convention
convento	convento: n. convent
conversação	conversação: n. conversation
converter	converter: convert
convir	convir: suit
convite	convite: n.m. invitation
convocação	convocação: n. announcement
convocar	convocar: set up, convocar: summon
cooperação	cooperação: n. cooperation
coordenação	coordenação: n. coordination
coordenador	coordenador: n. coordinator
coordenar	coordenar: coordinate
copa	copa: n. cup, copa: n. glass
cópia	cópia: n. copy
copyright	copyright: n. copyright
coração	coração: n. choir, coração: n. chorus, coração: n. heart
coragem	coragem: n.f. prowess
coral	coral: n. coral, coral: adj. choral
cor	cor: n.m. chorus, cor: n.f. colour, cor: n.m. heart
cordeiro	cordeiro: n.m. lamb
cordial	cordial: adj. cordial
coreano	coreano: n. Korean, coreano: adj. Korean
coroa	coroa: n. crown
coroar	coroar: top
coro	coro: n. chorus, coro: n. heart
coronel	coronel: n. colonel
corpo	corpo: n. body, corpo: n. corps
correção	correção: n. correction
correcção	correcção: n. correction
correctamente	correctamente: adv. correctly, correctamente: adv. just right, correctamente: adv. properly, correctamente: adv. rightly
correcto	correcto: adj.m.sg. correct, correcto: adj.f.sg. correct, correcto: adj.m.pl. correct, correcto: adj.f.pl. correct, correcto: adj.GD.pl. correct, correcto: adj. correct, correcto: adj. right
corredor	corredor: n. runner
correio	correio: n. mail, correio: n. post
corrente	corrente: n. chain, corrente: n.f. current, corrente: n.f. stream, corrente: n. string
correr	correr: race, correr: run
correspondência	correspondência: n. correspondence
correspondente	correspondente: adj. corresponding
corresponder	corresponder: correspond
corretamente	corretamente: adv. properly
correto	correto: adj.m.sg. correct, correto: adj.f.sg. correct, correto: adj.m.pl. correct, correto: adj.f.pl. correct, correto: adj. correct
corrida	corrida: n. career
corrigir	corrigir: correct
corrupção	corrupção: n. corruption
cortar	cortar: cut
corte	corte: n.m. cut, corte: n.m. slice
costa	costa: n.f.sg. coast
costas	costas: n.f.pl. back
costumar	costumar: accustom
costume	costume: n.m. custom, costume: n.m. habit
costura	costura: n. sewing
cota	cota: n. height
cotidiano	cotidiano: adj. daily
couro	couro: n. scalp
covarde	covarde: adj.mf. cowardly
cravar	cravar: pin
cravo	cravo: n.m. key, cravo: n.m. nail
credibilidade	credibilidade: n. credibility
crédito	crédito: n. credit
credor	credor: n. creditor
crença	crença: n. belief
crepúsculo	crepúsculo: n. dusk
crer	crer: believe, crer: think
crescente	crescente: adj. increasing
crescer	crescer: grow
crescimento	crescimento: n. growth
criação	criação: n. creation
criador	criador: n. creator
criança	criança: n.f. boy, criança: n.f. girl
criar	criar: breed, criar: contrive, criar: create, criar: raise
criatividade	criatividade: n. creativity
criativo	criativo: adj. creative
criatura	criatura: n. baby, criatura: n. creature
crime	crime: n. crime
criminal	criminal: n. criminal
criminalidade	criminalidade: n. criminality
crise	crise: n.f.ND. crisis, crise: n.f.sg. crisis, crise: n.f.pl. crisis
cristal	cristal: n. crystal
cristão	cristão: n. Christian, cristão: adj. Christian
critério	critério: n. criterion
criticar	criticar: criticize
crítico	crítico: n. critic, crítico: adj. critical
crónica	crónica: n. chronicle
crônica	crônica: n. chronicle
crónico	crónico: adj. chronic
crônico	crônico: adj. chronic
crucial	crucial: adj. crucial
cruel	cruel: adj. cruel, cruel: adj. ruthless
crueldade	crueldade: n. cruelty
cruzar	cruzar: cross
cruz	cruz: n. cross
cubano	cubano: adj. Cuban
cubo	cubo: n.m. bin, cubo: n.m. bucket
cuidado	cuidado: n.m. care, cuidado: n.m. cure
cuidar	cuidar: take care
culpa	culpa: n. blame, culpa: n. fault
culpar	culpar: blame
cultivo	cultivo: n. crop
culto	culto: n. cult, culto: adj. literate
cultura	cultura: n. culture
cultural	cultural: adj. cultural
cume	cume: n.f. peak
cumprir	cumprir: accomplish, cumprir: fulfil, cumprir: meet
cura	cura: n.f. care, cura: n.f. cure
curiosamente	curiosamente: adv. interestingly, curiosamente: adv. interestingly enough
curiosidade	curiosidade: n. curiosity
curioso	curioso: adj. curious
curso	curso: n. course
curto	curto: adj. short, curto: adj. witless
curva	curva: n. bend, curva: n. curve
custar	custar: cost
custo	custo: n. cost, custo: n. fee
dado	dado: n.m. data
dançar	dançar: dance
daninho	daninho: adj. harmful
dano	dano: n. damage, dano: n. injury
da noite para o dia	da noite para o dia: adv. from one day to the next
danoso	danoso: adj. harmful
dantes	dantes: adv. before
dar	dar: donate, dar: give
dar um beijo	dar um beijo: kiss
datar	datar: date
debaixo de	debaixo de: pr. under
debate	debate: n. debate
debater	debater: debate
deber	deber: vbmod. have to
débil	débil: adj. feeble, débil: adj. weak
debilidade	debilidade: n. weakness
década	década: n. decade
decadência	decadência: n. decadence, decadência: n. decay, decadência: n. decline
decepção	decepção: n.f. disappointment
decepcionar	decepcionar: disappoint
decidir	decidir: decide
decisão	decisão: n. decision
decisivo	decisivo: adj. decisive
declaração	declaração: n. statement
declarar	declarar: declare, declarar: state
decretar	decretar: decree
decreto	decreto: n. decree
de	de: pr. from, de: pr. of, de: pr. off
dedicar	dedicar: dedicate, dedicar: devote
dedo	dedo: n. finger, dedo: n. toe
dedução	dedução: n. deduction
deduzir	deduzir: deduce
de fato	de fato: adv. actually, de fato: adv. as a matter of fact, de fato: adv. in fact, de fato: adv. indeed
defender	defender: advocate, defender: defend
defensivo	defensivo: adj. defensive
defesa	defesa: n. defence
déficit	déficit: n. deficit
definição	definição: n. definition
definir	definir: define
definitivamente	definitivamente: adv. definitively
definitivo	definitivo: adj. definite, definitivo: adj. ultimate
defronte	defronte: adv. in front
degradar	degradar: degrade
degrau	degrau: n. stair
deixar	deixar: allow, deixar: give up, deixar: leave, deixar: lend, deixar: let
delegação	delegação: n. delegation
delegacia	delegacia: n. commissariat
delegado	delegado: n. delegate
delgado	delgado: adj. thin
delicadeza	delicadeza: n. delicacy
delicado	delicado: adj. delicate, delicado: adj. tricky
delito	delito: n. crime, delito: n. offence
demais	demais: adv. too much
demanda	demanda: n. demand
demasiadamente	demasiadamente: adv. too much
demasiado	demasiado: adv. too much
de má vontade	de má vontade: adv. reluctantly
demissão	demissão: n.f. dismissal
demitir	demitir: resign
democracia	democracia: n. democracy
democraticamente	democraticamente: adv. democratically
democrático	democrático: adj. democratic
de modo que	de modo que: cnjadv. so that
demográfico	demográfico: adj. demographical
demónio	demónio: n. demon
demônio	demônio: n. demon
demonstrar	demonstrar: demonstrate, demonstrar: show
denominar	denominar: call, denominar: denominate, denominar: name
densidade	densidade: n. density
denso	denso: adj. dense
dente	dente: n.m. tooth
dentro	dentro: adv. in, dentro: adv. within
denunciar	denunciar: denounce, denunciar: report
departamento	departamento: n. department
de passagem	de passagem: adv. in passing
dependência	dependência: n. dependence, dependência: n. dependency
depender	depender: depend
dependurar	dependurar: hang
depois de	depois de: pr. after
depois	depois: adv. after, depois: adv. afterwards, depois: adv. thereafter
deportação	deportação: n. deportation
deportar	deportar: deport
depositar	depositar: deposit
depósito	depósito: n. deposit, depósito: n. tank
depressa	depressa: adv. quickly
deputado	deputado: n. deputy
de repente	de repente: adv. all of a sudden, de repente: adv. on impulse, de repente: adv. out of the blue, de repente: adv. suddenly
derivar	derivar: derive
derramar	derramar: shed, derramar: spill
derrota	derrota: n. defeat
derrotar	derrotar: defeat
desabar	desabar: fall
desacordo	desacordo: n. disagreement
desafio	desafio: n. challenge
desaparecer	desaparecer: disappear
desaparecimento	desaparecimento: n.m. disappearance
desastre	desastre: n.m. disaster
desbloquear	desbloquear: unblock
descansar	descansar: rest
descaradamente	descaradamente: adv. blatantly
descendente	descendente: adj. downward
descenso	descenso: n. descent
descer	descer: descend
descoberta	descoberta: n.f. finding
descobrir	descobrir: discover, descobrir: find, descobrir: find out, descobrir: unveil
desconcertar	desconcertar: baffle
desconto	desconto: n. discount
descrever	descrever: depict, descrever: describe
descrição	descrição: n. description
desculpa	desculpa: n. excuse
desde	desde: pr. since
desdenhar	desdenhar: despise
desde que	desde que: cnjadv. since
desejar	desejar: desire, desejar: wish
desejo	desejo: n. desire, desejo: n. wish
desembocadura	desembocadura: n. mouth
desembocar	desembocar: discharge
desempenhar	desempenhar: occupy
desemprego	desemprego: n. unemployment
desencadear	desencadear: unchain
desenhador	desenhador: n. designer
desenhar	desenhar: design, desenhar: draw
desenho	desenho: n. design, desenho: n. drawing
desenvolver	desenvolver: develop
desenvolvimento	desenvolvimento: n. development, desenvolvimento: n. uncoiling
desequilíbrio	desequilíbrio: n. disequilibrium
deserto	deserto: n. desert
desespero	desespero: n.m. despair
desfazer	desfazer: undo
desfilar	desfilar: parade
desgosto	desgosto: n. discontent
desgraça	desgraça: n. misfortune
desgraçado	desgraçado: adj. miserable
designar	designar: designate
desigualdade	desigualdade: n. inequality
desinfectar	desinfectar: disinfect
desinfetar	desinfetar: disinfect
deslizar	deslizar: glide
deslocar	deslocar: displace
desmanchar	desmanchar: undo
desmentir	desmentir: explode
desnudar	desnudar: undress
desobediência	desobediência: n. disobedience
desolação	desolação: n. desolation
de sorte que	de sorte que: cnjadv. so that
despacho	despacho: n. dispatch
despedimento	despedimento: n. dismissal
despedir	despedir: fire, despedir: sack
despertar	despertar: awaken
despir	despir: undress
despojar	despojar: undress
desportista	desportista: n. sportsman
desportivo	desportivo: adj. sporting, desportivo: adj. sportive
desporto	desporto: n. sport
despregar	despregar: deploy
desprezar	desprezar: despise
desprezo	desprezo: n. contempt
destacar	destacar: highlight
desta guisa	desta guisa: adv. after this manner, desta guisa: adv. in this fashion, desta guisa: adv. in this way, desta guisa: adv. this way
destino	destino: n.m. destination, destino: n. fate
destroçar	destroçar: shatter
destruição	destruição: n. destruction
destruidor	destruidor: n. destroyer
destruir	destruir: destroy
desumano	desumano: adj. inhuman
desvanecer	desvanecer: dispel
desviar	desviar: divert
desvio	desvio: n.m. deviation
detalhar	detalhar: detail
detalhe	detalhe: n. detail
detectar	detectar: detect
detective	detective: n. detective, detective: n. investigator
detenção	detenção: n.f. arrest, detenção: n. arrest, detenção: n. detention
deter	deter: detain, deter: stop
determinação	determinação: n. determination
determinar	determinar: determine
detestar	detestar: detest
detetive	detetive: n. detective
detonar	detonar: detonate
detrás	detrás: adv. behind
deus	deus: n. god, deus: n. goddess
devagar	devagar: adv. slow, devagar: adv. slowly
devastar	devastar: devastate
dever	dever: n. duty, dever: n. duty, dever: n. duty, dever: n. homework, dever: n. homework, dever: vbmod. have to, dever: owe
devidamente	devidamente: adv. properly
devido a	devido a: pr. because of, devido a: pr. due to
devir	devir: become
devolver	devolver: return
dezanove	dezanove: num. nineteen
dezasseis	dezasseis: num. sixteen
dezassete	dezassete: num. seventeen
dez	dez: num. ten
dezembro	dezembro: n. December
dezena	dezena: n. ten
dezenove	dezenove: num. nineteen
dezesseis	dezesseis: num. sixteen
dezessete	dezessete: num. seventeen
dezoito	dezoito: num. eighteen
dia	dia: n. day
diagnóstico	diagnóstico: n. diagnostic
diagonal	diagonal: n. diagonal, diagonal: adj. diagonal
dialéctica	dialéctica: n. dialectics
dialecto	dialecto: n. dialect
dialética	dialética: n. dialectics
dialeto	dialeto: n. dialect
diálogo	diálogo: n. dialog, diálogo: n. dialogue
diamante	diamante: n. diamond
diante	diante: adv. in front
diariamente	diariamente: adv. daily, diariamente: adv. on a day-to-day basis
diário	diário: adj. daily, diário: adj. everyday
dicionário	dicionário: n. dictionary
didáctico	didáctico: adj. didactic
didático	didático: adj. didactic
diferença	diferença: n. difference
diferente	diferente: adj. different, diferente: adj.mf. distinct, diferente: adj. unlike
difícil	difícil: adj. difficult
dificilmente	dificilmente: adv. hardly, dificilmente: adv. scarcely
dificuldade	dificuldade: n. difficulty
dificultar	dificultar: hamper
digital	digital: adj. digital
dignidade	dignidade: n. dignity
digno	digno: adj. worthy
dimensão	dimensão: n. dimension
diminuição	diminuição: n. decline, diminuição: n. decrease
diminuir	diminuir: diminish
dinamarquês	dinamarquês: adj. Danish
dinâmico	dinâmico: adj. dynamic
diplomacia	diplomacia: n. diplomacy
diplomático	diplomático: adj. diplomatic
direção	direção: n. address
direcção	direcção: n. address, direcção: n. direction
directamente	directamente: adv. directly
directo	directo: adj.m.sg. direct, directo: adj.f.sg. direct, directo: adj.m.pl. direct, directo: adj.f.pl. direct, directo: adj.GD.pl. direct, directo: adj. direct
director	director: n. conductor, director: n. director, director: n. manager
directriz	directriz: n. guideline
direita	direita: n. right
direito	direito: n. law, direito: n. right, direito: adj. right, direito: adj. right-hand
diretamente	diretamente: adv. directly
direto	direto: adj.m.sg. direct, direto: adj.f.sg. direct, direto: adj.m.pl. direct, direto: adj.f.pl. direct, direto: adj. direct
diretor	diretor: n. conductor, diretor: n. director
diretriz	diretriz: n. guideline
dirigente	dirigente: n. leader
dirigir	dirigir: address, dirigir: aim, dirigir: conduct, dirigir: direct, dirigir: lead, dirigir: manage
disciplina	disciplina: n. discipline
disco	disco: n. disc, disco: n. disk
discórdia	discórdia: n. discord
discrepância	discrepância: n. discrepancy
discreto	discreto: adj. discreet
discriminação	discriminação: n. discrimination
discurso	discurso: n. discourse, discurso: n. speech
discussão	discussão: n. argument, discussão: n. discussion
discutir	discutir: argue
disfarce	disfarce: n.m. costume
disparar	disparar: discharge, disparar: fire, disparar: shoot
disparo	disparo: n. shot
disponível	disponível: adj. available
disposição	disposição: n. disposal, disposição: n. distribution, disposição: n. resolution, disposição: n. willingness
dispositivo	dispositivo: n. device
disputar	disputar: contest
dissolução	dissolução: n. dissolution
dissolver	dissolver: dissolve
distância	distância: n. distance
distante	distante: adj. distant
distinguir	distinguir: distinguish
distração	distração: n.f. distraction
distracção	distracção: n.f. distraction
distrair	distrair: distract
distribuição	distribuição: n. distribution
distribuir	distribuir: distribute
distrito	distrito: n. district
ditador	ditador: n. dictator
ditadura	ditadura: n. dictatorship
ditar	ditar: dictate
ditoso	ditoso: adj. joyous
diversidade	diversidade: n. diversity
diverso	diverso: adj. diverse, diverso: adj. varied
divertir	divertir: amuse
dívida	dívida: n.f. debt
dividir	dividir: divide
divino	divino: adj. divine
divisão	divisão: n. division
divorciar	divorciar: divorce
divórcio	divórcio: n. divorce
divulgar	divulgar: spread
dizer	dizer: say, dizer: tell
dobrar	dobrar: bend
doce	doce: adj.mf. mellow, doce: adj.mf. sweet
documentação	documentação: n. documentation
documental	documental: n. documentary, documental: adj. documentary
documentar	documentar: document
documento	documento: n. document
doença	doença: n. disease, doença: n. illness
doente	doente: adj.mf. ill, doente: adj.mf. sick
dólar	dólar: n. dollar
doloroso	doloroso: adj. painful
dom	dom: n. gift
do mesmo modo	do mesmo modo: adv. in the same way
doméstico	doméstico: adj. domestic
domicílio	domicílio: n. domicile
dominante	dominante: adj. dominant
dominar	dominar: dominate
domingo	domingo: n. Sunday
domínio	domínio: n. command
dono	dono: n.m. landlord, dono: n.f. owner
dor	dor: n.f. pain
dormir	dormir: sleep
dormitório	dormitório: n. bedroom
dose	dose: n.f.ND. dose, dose: n.f.sg. dose, dose: n.f.pl. dose
dourar	dourar: gild
doutor	doutor: n. doctor
doutrina	doutrina: n. doctrine
doze	doze: num. twelve
dragão	dragão: n. dragon
drama	drama: n. drama
dramático	dramático: adj. dramatic
dramaturgo	dramaturgo: n. dramatist
droga	droga: n. drug
duelo	duelo: n. duel
dupla	dupla: n. couple
duplo	duplo: adj.GD. double, duplo: adj.m. double, duplo: adj.f. double, duplo: adj.GD. twofold
duque	duque: n. duke
duração	duração: n. duration
duradouro	duradouro: adj. durable, duradouro: adj. lasting
durante	durante: pr. during, durante: pr. for, durante: pr. over, durante: pr. throughout
durar	durar: last
duro	duro: adj. hard, duro: adj. harsh, duro: adj. tough
dúvida	dúvida: n.f. doubt
duvidar	duvidar: doubt, duvidar: hesitate
dúzia	dúzia: n. dozen
eclesiástico	eclesiástico: adj. ecclesiastical
eco	eco: n. echo
ecológico	ecológico: adj. ecological
economia	economia: n. economics, economia: n. economy
economicamente	economicamente: adv. economically
económico	económico: adj. economic, económico: adj. economical
econômico	econômico: adj. economic, econômico: adj. economical
economista	economista: n. economist
edição	edição: n. edition
edifício	edifício: n. building
editar	editar: edit
editor	editor: n. editor, editor: n. publisher
educação	educação: n. education
educar	educar: educate
educativo	educativo: adj. educational, educativo: adj. educative
efectivamente	efectivamente: adv. sure enough
efectuar	efectuar: effect
efeito	efeito: n. effect
efémero	efémero: adj. ephemeral
efêmero	efêmero: adj. ephemeral
efetivamente	efetivamente: adv. sure enough
efetuar	efetuar: effect
eficácia	eficácia: n. efficiency
eficaz	eficaz: adj.mf.pl. effective, eficaz: adj.mf.sg. effective, eficaz: adj.mf.pl. efficient, eficaz: adj.mf.sg. efficient
eficazmente	eficazmente: adv. effectively
egípcio	egípcio: adj. Egyptian
egoísmo	egoísmo: n. selfishness
eixo	eixo: n. axis
elaborar	elaborar: elaborate
electricidade	electricidade: n. electricity
eléctrico	eléctrico: n. streetcar, eléctrico: n. tram, eléctrico: n. tramcar, eléctrico: n. tramway, eléctrico: adj. electrical
electrodoméstico	electrodoméstico: n. appliance
electrónico	electrónico: adj. electronic
elegante	elegante: adj. elegant, elegante: adj. fancy
eleger	eleger: choose, eleger: elect, eleger: pick
eleição	eleição: n.f. choice, eleição: n.f. election
eleitoral	eleitoral: adj. electoral
elementar	elementar: adj. elementary
elemento	elemento: n. element, elemento: n. item
eletricidade	eletricidade: n. electricity
elétrico	elétrico: adj. electrical
eletrodoméstico	eletrodoméstico: n. appliance
eletrônico	eletrônico: adj. electronic
elevado	elevado: adj. overhead
elevador	elevador: n. elevator, elevador: n. lift
elevar	elevar: elevate
eliminação	eliminação: n. disposal, eliminação: n. elimination, eliminação: n. removal
eliminar	eliminar: delete, eliminar: eliminate
elite	elite: n. elite
elogio	elogio: n. praise
eludir	eludir: evade
em abundância	em abundância: adv. in abundance, em abundância: adv. in plenty
embaixada	embaixada: n. embassy
embaixador	embaixador: n. ambassador
embaixo de	embaixo de: pr. under
embaixo	embaixo: adv. under
embarcação	embarcação: n. craft
embarcar	embarcar: embark, embarcar: ship
embora	embora: cnjadv. although
embrião	embrião: n. embryo
em cima	em cima: adv. above, em cima: adv. on, em cima: adv. uppermost
em consequência de	em consequência de: pr. as a consequence of
em curto prazo	em curto prazo: adv. in the short term, em curto prazo: adv. on a short-term basis, em curto prazo: adv. on a small scale
em	em: pr. at, em: pr. in, em: pr. on
emenda	emenda: n. amendment
emergência	emergência: n. emergency
emergente	emergente: adj. emergent
em frente	em frente: adv. in front
emigrante	emigrante: n. emigrant, emigrante: adj. migrant
emigrar	emigrar: emigrate, emigrar: migrate
emissão	emissão: n. broadcast, emissão: n. emission, emissão: n. release
emitir	emitir: issue
em longo prazo	em longo prazo: adv. on a long-term basis
em massa	em massa: adj.mf.sp. massive, em massa: adv. massively
em media	em media: adv. on the average
emoção	emoção: n. emotion, emoção: n. excitement, emoção: n. thrill
emocional	emocional: adj. emotional
emocionalmente	emocionalmente: adv. emotionally
emocionar	emocionar: thrill
empate	empate: n. tie
empreender	empreender: tackle, empreender: undertake
empregar	empregar: employ
emprego	emprego: n.m. employment, emprego: n.m. occupation
empresa	empresa: n. company, empresa: n. corporation, empresa: n. enterprise, empresa: n. firm
empresarial	empresarial: adj. business
empresário	empresário: n. employer
emprestar	emprestar: loan
empréstimo	empréstimo: n. loan
em primeiro lugar	em primeiro lugar: adv. firstly, em primeiro lugar: adv. in the first instance, em primeiro lugar: adv. in the first place
empurrão	empurrão: n.m. drive, empurrão: n.m. push
empurrar	empurrar: push, empurrar: thrust
em redor	em redor: adv. around
em seguida	em seguida: adv. forthwith, em seguida: adv. immediately, em seguida: adv. in a little while, em seguida: adv. in short order, em seguida: adv. right away, em seguida: adv. straight away, em seguida: adv. then and there, em seguida: adv. there and then
em troca	em troca: adv. in exchange, em troca: adv. in return, em troca: adv. in turn
em vão	em vão: adv. in vain
em vez de	em vez de: pr. instead of
encabeçar	encabeçar: head
encadear	encadear: chain
encantar	encantar: love
encarcerar	encarcerar: imprison
encarnar	encarnar: embody
encarregado	encarregado: n. attendant
encerramento	encerramento: n. closing
encerrar	encerrar: conclude
encher	encher: fill
encontrar	encontrar: come across, encontrar: encounter, encontrar: find
encontro	encontro: n.m. meeting
encrespar	encrespar: crimp
endémico	endémico: adj. endemical
endereço	endereço: n.m. address
endurecer	endurecer: toughen
energético	energético: adj. energetic
energia	energia: n. energy, energia: n. power
enérgico	enérgico: adj. forceful
enfeitar	enfeitar: garnish
enfermagem	enfermagem: n. infirmary
enfermaria	enfermaria: n. infirmary
enfermeiro	enfermeiro: n. nurse
enfermidade	enfermidade: n. illness
enfim	enfim: adv. finally
enfoque	enfoque: n. approach
enfrentar	enfrentar: confront
enganar	enganar: cheat, enganar: deceive, enganar: trap
engenharia	engenharia: n. engineering
engenheiro	engenheiro: n. engineer
enlaçar	enlaçar: link
enorme	enorme: adj. enormous, enorme: adj. huge, enorme: adj. tremendous
enormemente	enormemente: adv. enormously
enquanto	enquanto: cnjadv. as, enquanto: cnjadv. while
enriquecimento	enriquecimento: n. enrichment
ensaio	ensaio: n. essay, ensaio: n. rehearsal
ensinamento	ensinamento: n.f. education, ensinamento: n.f. teaching
ensinar	ensinar: teach
ensino	ensino: n.m. education, ensino: n.m. teaching
então	então: adv. then
entender	entender: understand
entendimento	entendimento: n.m. understanding
enterrar	enterrar: bury
entidade	entidade: n. entity
entrada	entrada: n. entrance, entrada: n. entry, entrada: n. input, entrada: n. ticket
entranhar	entranhar: comport
entrar	entrar: come in, entrar: go in, entrar: step into
entre	entre: pr. amid, entre: pr. among, entre: pr. amongst, entre: pr. between
entrega	entrega: n.f. delivery
entregar	entregar: hand, entregar: rid, entregar: submit
entrever	entrever: glimpse
entrevista	entrevista: n. interview
entrevistar	entrevistar: interview
entusiasmar	entusiasmar: excite
entusiasmo	entusiasmo: n. enthusiasm
envelhecer	envelhecer: age
envergonhar	envergonhar: embarrass
enviar	enviar: forward, enviar: send, enviar: send in
envolver	envolver: pack, envolver: wrap
envolvimento	envolvimento: n.m. implication, envolvimento: n.m. involvement
eólico	eólico: adj. aeolian
epidemia	epidemia: n. epidemic
episódio	episódio: n.m. anecdote, episódio: n. episode
época	época: n. period
equatoriano	equatoriano: adj. Ecuadorian
equilibrar	equilibrar: balance
equilíbrio	equilíbrio: n. balance, equilíbrio: n. equilibrium
equipa	equipa: n.f. gear, equipa: n.f. team
equipamento	equipamento: n. equipment
equipar	equipar: equip, equipar: instrument
equipe	equipe: n.f. team
equivalente	equivalente: adj. equivalent
erradicar	erradicar: eradicate
erro	erro: n. error
erróneo	erróneo: adj. erroneous
errôneo	errôneo: adj. erroneous
erupção	erupção: n. eruption
erva	erva: n. grass
escada	escada: n.f. scale, escada: n.f. scale, escada: n.f. stair, escada: n.f. stair
escândalo	escândalo: n. scandal
escasso	escasso: adj. scarce
escocês	escocês: n. Scottish, escocês: adj. Scottish
escolar	escolar: adj. school
escolha	escolha: n.f. election
escolher	escolher: choose
escombro	escombro: n. demolition
esconder	esconder: hide
esconderijo	esconderijo: n. hide
escorregar	escorregar: slip
escravo	escravo: n. slave
escrever	escrever: type, escrever: write
escrita	escrita: n. writing
escrito	escrito: n. writing
escritor	escritor: n. writer
escritório	escritório: n.m. office
escritura	escritura: n. writing
escudo	escudo: n. shield
escurecer	escurecer: darken
escuridade	escuridade: n. darkness
escuridão	escuridão: n. dark, escuridão: n. darkness
escuro	escuro: adj. dark, escuro: adj. obscure
escutar	escutar: listen
esforço	esforço: n. effort
esfregar	esfregar: rub
esgotar	esgotar: deplete
esmola	esmola: n. alms
espacial	espacial: adj. space, espacial: adj. spatial
espaço	espaço: n. blank, espaço: n. space
espada	espada: n. sword
espanhol	espanhol: n. Spaniard, espanhol: adj. Spanish
espantar	espantar: scare
especial	especial: adj. special
especialista	especialista: n. specialist
especialmente	especialmente: adv. especially, especialmente: adv. specially
espécie	espécie: n. species
especificamente	especificamente: adv. specifically
especificar	especificar: specify
específico	específico: adj. specific
espectacular	espectacular: adj. spectacular
espectáculo	espectáculo: n. show
espectador	espectador: n. viewer
espectro	espectro: n. spectrum
especulação	especulação: n. speculation
especulativo	especulativo: adj. speculative
espelho	espelho: n. mirror
esperança	esperança: n. hope
esperar	esperar: await, esperar: expect, esperar: hope, esperar: wait
espetacular	espetacular: adj. spectacular
espetáculo	espetáculo: n. show
espionagem	espionagem: n.f. espionage
espírito	espírito: n. spirit
espiritual	espiritual: adj. spiritual
esplendor	esplendor: n.m. splendour
esporte	esporte: n. sport
esportivo	esportivo: adj. sportive
esquecer	esquecer: forget
esqueleto	esqueleto: n. skeleton
esquema	esquema: n. diagram, esquema: n. outline, esquema: n. scheme
esquentamento	esquentamento: n. warming
esquentar	esquentar: heat
esquerdista	esquerdista: adj.mf. left-handed
esquerdo	esquerdo: adj. lefthand
esqui	esqui: n. ski
esquí	esquí: n. ski
esse	esse: det. this, esse: prn. this
estabelecer	estabelecer: establish
estabelecimento	estabelecimento: n. establishment
estação	estação: n. season, estação: n. station
estacionamento	estacionamento: n. parking
estacionar	estacionar: park
estadia	estadia: n. stay
estádio	estádio: n. stadium
estado	estado: n. state, estado: n. status
estância	estância: n. chamber, estância: n. stay
estar	estar: stand
estatal	estatal: adj. state
estatístico	estatístico: adj. statistical
estátua	estátua: n. statue
estatutário	estatutário: adj. statutory
estatuto	estatuto: n. statute
este	este: det. this, este: prn. this, este: prn. this
estender	estender: extend, estender: spread
estéril	estéril: adj. barren
estético	estético: adj. aesthetic
esticar	esticar: pull, esticar: strain, esticar: stretch
estilo	estilo: n. style
estimar	estimar: love
estimulação	estimulação: n. stimulation
estimular	estimular: boost, estimular: stimulate
estímulo	estímulo: n. stimulus
estipular	estipular: stipulate
estômago	estômago: n. stomach, estômago: n. stomach
estorvar	estorvar: disturb
estrada	estrada: n. highway, estrada: n. road
estrangeiro	estrangeiro: n. alien, estrangeiro: n. foreigner, estrangeiro: adj. foreign
estratégia	estratégia: n. strategy
estratégico	estratégico: adj. strategic
estréia	estréia: n.f. première
estreitamente	estreitamente: adv. tightly
estreito	estreito: adj. narrow
estrela	estrela: n. star
estrella	estrella: n. star
estridente	estridente: adj. strident
estritamente	estritamente: adv. strictly
estrito	estrito: adj. strict
estrutura	estrutura: n. frame, estrutura: n. structure
estrutural	estrutural: adj. structural
estudante	estudante: n.mf. student
estudar	estudar: study
estúdio	estúdio: n. studio, estúdio: n. study
estudo	estudo: n. studio, estudo: n. study
estufa	estufa: n. oven, estufa: n. stove
estupidez	estupidez: n. stupidity
estúpido	estúpido: adj. stupid
etapa	etapa: n. stage
eternamente	eternamente: adv. evermore
eternidade	eternidade: n. eternity
eterno	eterno: adj. eternal
ético	ético: adj. ethical
etiqueta	etiqueta: n. label
etiquetar	etiquetar: label
etnia	etnia: n. ethnic group
étnico	étnico: adj. ethnic
euro	euro: n. euro
europeu	europeu: n. European, europeu: adj. European
eutanásia	eutanásia: n. euthanasia
evacuação	evacuação: n. evacuation
evacuar	evacuar: evacuate
evento	evento: n. event
eventual	eventual: adj. eventual
evidência	evidência: n. evidence, evidência: n. exhibit
evidente	evidente: adj. evident
evidentemente	evidentemente: adv. evidently, evidentemente: adv. obviously
evitar	evitar: avoid, evitar: prevent
evocar	evocar: evoke
evolução	evolução: n. evolution
evoluir	evoluir: evolve
exactamente	exactamente: adv. exactly, exactamente: adv. just
exacto	exacto: adj. exact
exagerar	exagerar: exaggerate
exame	exame: n. exam, exame: n. examination
examinar	examinar: examine
exatamente	exatamente: adv. exactly
exato	exato: adj. exact
exceção	exceção: n. exception
excelente	excelente: adj. excellent
excepção	excepção: n. exception
excepcional	excepcional: adj. exceptional, excepcional: adj. outstanding
excepto	excepto: pr. but, excepto: pr. except, excepto: pr. except for
excessivamente	excessivamente: adv. excessively
excessivo	excessivo: adj. excessive
excesso	excesso: n. excess
exceto	exceto: pr. except
excitação	excitação: n. excitation
exclamar	exclamar: exclaim
excluir	excluir: exclude
exclusão	exclusão: n. exclusion
exclusivamente	exclusivamente: adv. exclusively
exclusivo	exclusivo: adj. exclusive
execução	execução: n. execution
executivo	executivo: n. executive
exemplo	exemplo: n. example
exercer	exercer: exert
exercício	exercício: n. exercise
exército	exército: n. army
exibir	exibir: exhibit
exílio	exílio: n. exile
existência	existência: n. existence
existente	existente: adj. existent
existir	existir: exist
êxito	êxito: n. success
expansão	expansão: n. expansion
expectativa	expectativa: n. expectation
expedição	expedição: n. expedition
expediente	expediente: n. file
experiência	experiência: n. experience
experimentar	experimentar: experience, experimentar: undergo
experimento	experimento: n. experiment
explicação	explicação: n. explanation
explicar	explicar: explain
explodir	explodir: explode, explodir: exploit
exploração	exploração: n. exploitation, exploração: n. exploration
explorar	explorar: explore
explosão	explosão: n. burst, explosão: n. explosion
explosivo	explosivo: n. explosive, explosivo: adj. explosive
expor	expor: expose
exportação	exportação: n. export
exportar	exportar: export
exposição	exposição: n. exhibit, exposição: n. exhibition, exposição: n. exposure
expressamente	expressamente: adv. on purpose, expressamente: adv. purposely
expressão	expressão: n. expression
exprimir	exprimir: express
expulsão	expulsão: n. expulsion
expulsar	expulsar: expel
êxtase	êxtase: n.m.ND. ecstasy, êxtase: n.m.sg. ecstasy, êxtase: n.m.pl. ecstasy
extensão	extensão: n. extension, extensão: n. extent
extenso	extenso: adj. extensive
exterior	exterior: n. outside, exterior: adj. exterior, exterior: adj. outdoor, exterior: adj. outer, exterior: adj. outside
externo	externo: adj. external
extinção	extinção: n. extinction
extorsão	extorsão: n. extortion
extração	extração: n. extraction
extracção	extracção: n. extraction
extradição	extradição: n. extradition
extrair	extrair: extract
extraordinariamente	extraordinariamente: adv. extraordinarily, extraordinariamente: adv. remarkably
extraordinário	extraordinário: adj. exquisite, extraordinário: adj. extraordinary
extremamente	extremamente: adv. exceedingly, extremamente: adv. extremely, extremamente: adv. monumentally
extremo	extremo: n. extreme, extremo: adj. extreme
fabricação	fabricação: n. manufacture, fabricação: n. manufacturing
fábrica	fábrica: n. factory
fabricante	fabricante: n. maker, fabricante: n. manufacturer
fabricar	fabricar: manufacture
faca	faca: n.f. knife
facção	facção: n. faction
faceta	faceta: n. facet
fachada	fachada: n. façade
facial	facial: adj. facial
fácil	fácil: adj. easy
facilidade	facilidade: n. ease, facilidade: n. facility
facilitar	facilitar: facilitate
facilmente	facilmente: adv. easily, facilmente: adv. effortlessly
facto	facto: n. fact
factor	factor: n. factor
facturação	facturação: n. turnover
factura	factura: n. bill, factura: n. invoice
faiscante	faiscante: adj.mf. shiny
fala	fala: n. speech
falar	falar: discuss, falar: speak, falar: talk
falecer	falecer: die
falha	falha: n.f. failure
falhanço	falhanço: n. failure
falhar	falhar: fail
falsidade	falsidade: n. falsity
falsificação	falsificação: n. fake
falso	falso: adj. false
falta	falta: n. fault
faltar	faltar: be missing
fama	fama: n. fame
família	família: n. family
familiar	familiar: adj. familiar, familiar: adj. family
famoso	famoso: adj. famous
fanático	fanático: adj. fanatical
fantasma	fantasma: n. ghost
fantástico	fantástico: adj. fantastic
fantoche	fantoche: n.m. puppet
farinha	farinha: n. flour
farmacêutico	farmacêutico: n. chemist
farmácia	farmácia: n. chemist's, farmácia: n. drugstore, farmácia: n. pharmacy
farsa	farsa: n. farce
fartura	fartura: n. abundance
fase	fase: n. phase
fatal	fatal: adj. fatal
fato	fato: n. fact
fator	fator: n. factor
faturação	faturação: n. turnover
fatura	fatura: n. bill
favorável	favorável: adj. favorable, favorável: adj. favourable
favorecer	favorecer: favour
favor	favor: n. favour
favorito	favorito: adj. favourite
fazer	fazer: do, fazer: make, fazer: take
fechamento	fechamento: n. closing
fechar	fechar: close, fechar: enclose, fechar: shut, fechar: shut down
federação	federação: n. federation
federal	federal: adj. federal
fedor	fedor: n. stink
fé	fé: n. faith
feio	feio: adj. ugly
feira	feira: n. fair
felicidade	felicidade: n. happiness
feliz	feliz: adj.mf. glad, feliz: adj.mf. happy
felizmente	felizmente: adv. fortunately, felizmente: adv. happily, felizmente: adv. luckily, felizmente: adv. thankfully
feminino	feminino: adj. feminine
fenómeno	fenómeno: n. phenomenon
fenômeno	fenômeno: n. phenomenon
férias	férias: n. holiday, férias: n. holiday, férias: n. holiday, férias: n. vacation, férias: n. vacation
ferimento	ferimento: n.m. wound
feroz	feroz: adj.mf.pl. fierce, feroz: adj.mf.sg. fierce
ferramenta	ferramenta: n. tool
ferreiro	ferreiro: n. smith
ferro	ferro: n. iron, ferro: n.m. iron, ferro: n.m. plate
festa	festa: n. party
festival	festival: n. festival
fevereiro	fevereiro: n. February
fezes	fezes: n.f.pl. feces
fibra	fibra: n. fiber, fibra: n. fibre, fibra: n. grain
ficar	ficar: be left, ficar: remain, ficar: stay
ficção	ficção: n. fiction
fiel	fiel: adj. faithful
figura	figura: n. figure
fila	fila: n. row
filho	filho: n. child, filho: n. daughter, filho: n. son, filho: n. son
filial	filial: adj. filial
filme	filme: n.m. film, filme: n.m. movie
fim	fim: n.m. end
final	final: n. end, final: n. ending, final: n. final, final: adj. final
finalista	finalista: n. finalist
finalmente	finalmente: adv. eventually, finalmente: adv. finally, finalmente: adv. ultimately
financeiro	financeiro: adj. financial
financiamento	financiamento: n.m. funding
financiar	financiar: finance, financiar: fund
fincar	fincar: pin
fino	fino: adj. fine
fio	fio: n. thread, fio: n. wire
firma	firma: n. signature
firmamento	firmamento: n. firmament
firmar	firmar: sign
firme	firme: adj.mf. firm
fiscal	fiscal: adj. fiscal
fisicamente	fisicamente: adv. physically
físico	físico: adj. physical
fita	fita: n. strip, fita: n. tape
fixo	fixo: adj. fixed
flecha	flecha: n. arrow
flexibilidade	flexibilidade: n. flexibility
flexível	flexível: adj. flexible, flexível: adj. floppy
floral	floral: adj. floral
florescer	florescer: flower
flor	flor: n. flower
fluir	fluir: flow
fluxo	fluxo: adj. toneless
foco	foco: n.m.ND. focus, foco: n.m.pl. focus, foco: n.m.sg. focus
fogo	fogo: n. fire
fogueira	fogueira: n. bonfire
foguete	foguete: n. rocket
folha	folha: n.f. blade, folha: n.f. leaf, folha: n.f. sheet
fonte	fonte: n. fountain, fonte: n. source, fonte: n. spring
fora	fora: adv. away, fora: adv. off, fora: adv. out, fora: adv. outside
força	força: n. force, força: n. strength
formação	formação: n. formation, formação: n. training
forma	forma: n.f. form, forma: n.f. shape
formal	formal: adj. formal
formalizar	formalizar: formalize
formalmente	formalmente: adv. formally
formar	formar: form
formato	formato: n. format
formoso	formoso: adj. beautiful
fórmula	fórmula: n. formula
formular	formular: formulate
fornecer	fornecer: supply
fornecimento	fornecimento: n. supply
forno	forno: n. oven
foro	foro: n. forum
fortalecer	fortalecer: fortify, fortalecer: strengthen
fortaleza	fortaleza: n. fortress
forte	forte: adj.mf. strong
fortemente	fortemente: adv. heavily, fortemente: adv. strongly
fortuna	fortuna: n. fortune
fóssil	fóssil: n. fossil
foto	foto: n. photo
fotografar	fotografar: photograph
fotógrafo	fotógrafo: n. photographer
fração	fração: n.f. fraction
fracasso	fracasso: n. failure
fracção	fracção: n.f. fraction
fraco	fraco: adj.m. feeble, fraco: adj.f. feeble
fractura	fractura: n. fracture
frágil	frágil: adj. fragile
fragmento	fragmento: n. fragment
francamente	francamente: adv. frankly, francamente: adv. outright
francês	francês: n. French, francês: adj. French
franco	franco: adj. frank
frango	frango: n. chicken
franzino	franzino: adj. thin
frase	frase: n. phrase, frase: n. sentence
fratura	fratura: n. fracture
fraude	fraude: n.f. fraud
frear	frear: brake
freguesia	freguesia: n. clientele
frente	frente: n.f. front, frente: adv. in front
frequência	frequência: n. frequency
freqüência	freqüência: n. frequency
frequente	frequente: adj. frequent
freqüente	freqüente: adj. frequent
frequentemente	frequentemente: adv. frequently
freqüentemente	freqüentemente: adv. frequently
fresco	fresco: adj. cool, fresco: adj. fresh
frialdade	frialdade: n. coolness
frieza	frieza: n. coolness
frio	frio: n. cold, frio: adj. cold
frisar	frisar: crimp
frontal	frontal: adj. frontal
fronteira	fronteira: n. border, fronteira: n. boundary, fronteira: n. frontier
frota	frota: n. fleet
fruta	fruta: n. fruit
fruto	fruto: n. fruit
fuga	fuga: n. fugue
fulgor	fulgor: n. glow
fumaça	fumaça: n.f. smoke
fumar	fumar: smoke
fumo	fumo: n. tobacco
função	função: n. function, função: n. role
funcionamento	funcionamento: n. functioning, funcionamento: n. operation
funcionar	funcionar: function, funcionar: operate, funcionar: run, funcionar: work
fundação	fundação: n. foundation
fundador	fundador: n. founder
fundamental	fundamental: adj. fundamental
fundamentalista	fundamentalista: n. fundamentalist
fundamentalmente	fundamentalmente: adv. fundamentally
fundar	fundar: found
fundir	fundir: cast, fundir: melt
fundo	fundo: n.m.ND. background, fundo: n.m.pl. background, fundo: n.m.sg. background, fundo: n.m.ND. bottom, fundo: n.m.pl. bottom, fundo: n.m.sg. bottom, fundo: n.m.ND. fund, fundo: n.m.pl. fund, fundo: n.m.sg. fund, fundo: adj. deep
funeral	funeral: n. funeral
furacão	furacão: n. hurricane
furia	furia: n. fury
furioso	furioso: adj. furious, furioso: adj. raging
fusão	fusão: n. fusion, fusão: n. merger
futebol	futebol: n. football
futebolista	futebolista: n. footballer
futuro	futuro: n. future, futuro: adj. future
gabinete	gabinete: n. cabinet
gala	gala: n. gala
galego	galego: n. galician
galo	galo: n. rooster
ganhador	ganhador: n. winner
ganhar	ganhar: earn, ganhar: win
ganho	ganho: n.m. gain
garagem	garagem: n.f. garage
garantir	garantir: guarantee
garganta	garganta: n. throat
garoto	garoto: n. boy, garoto: n. girl, garoto: n. lad
garrafa	garrafa: n. bottle
garra	garra: n. harp
gás	gás: n. gas
gasolina	gasolina: n.f. benzine, gasolina: n.f. gasoline, gasolina: n.f. petrol
gastar	gastar: spend
gasto	gasto: n.m. expenditure, gasto: n.m. expense
gato	gato: n. cat
gelo	gelo: n. ice
gene	gene: n. gene
general	general: n. general
generalizar	generalizar: generalize
gênero	gênero: n. gender
género	género: n. gender, género: n. genre
generoso	generoso: adj. generous
genético	genético: adj. genetic
génio	génio: n. genius
gênio	gênio: n. genius
genital	genital: adj. genital
genocídio	genocídio: n. genocide
gente	gente: n. person
geográfico	geográfico: adj. geographic
geológico	geológico: adj. geological
geração	geração: n. generation
geral	geral: adj. general
geralmente	geralmente: adv. commonly, geralmente: adv. generally
gestão	gestão: n. management, gestão: n. negotiation
gesto	gesto: n. gesture
gigante	gigante: n. giant
gigantesco	gigantesco: adj. gigantic
ginete	ginete: n. rider
girar	girar: turn
giro	giro: n. twist
global	global: adj. global
globalização	globalização: n. globalization
glória	glória: n. glory
goleiro	goleiro: n. goalkeeper
gol	gol: n. goal
golo	golo: n. goal
golpear	golpear: knock, golpear: strike
golpe	golpe: n. blow, golpe: n. coup, golpe: n. knock, golpe: n. stroke
gordura	gordura: n.f. fat
gostar	gostar: enjoy, gostar: fancy, gostar: like
gota	gota: n. drop
governação	governação: n.f. government
governante	governante: n. ruler
governo	governo: n. government
graça	graça: n.f. grace
graças a	graças a: pr. thanks to
grade	grade: n. grille
gráfico	gráfico: n. chart, gráfico: n. graphics, gráfico: adj. graphic
grama	grama: n.f. gram, grama: n.f. gramme, grama: n.f. lawn
granada	granada: n. pomegranate
grande	grande: adj. big, grande: adj. elder, grande: adj. great, grande: adj. large
grandeza	grandeza: n. greatness
granito	granito: n. granite
granja	granja: n. farm
grão	grão: n. grain, grão: n. spot
gratuito	gratuito: adj. free
gravação	gravação: n.f. recording
gravar	gravar: record, gravar: tax
grave	grave: adj. grave, grave: adj. severe
gravemente	gravemente: adv. gravely
gravidade	gravidade: n. gravity
gravidez	gravidez: n.f. pregnancy
grego	grego: adj. Greek
greve	greve: n. strike
gripe	gripe: n. flu
gritar	gritar: call, gritar: cry, gritar: scream, gritar: shout
grito	grito: n. cry, grito: n. shout
grosseiro	grosseiro: adj. earthy
grupo	grupo: n. cluster, grupo: n. group, grupo: n. pack, grupo: n. pool
gruta	gruta: n. cave
guarda-costas	guarda-costas: n. bodyguard
guarda	guarda: n. guard, guarda: n. policeman
guardar	guardar: save
guerra	guerra: n. war
guerreiro	guerreiro: n. warrior
guerrilha	guerrilha: n. guerrilla warfare
guerrilheiro	guerrilheiro: n. guerrilla warfare
guião	guião: n. script
guiar	guiar: guide
hábil	hábil: adj. skillful
habilidade	habilidade: n. ability, habilidade: n. craft, habilidade: n. skill
habilitação	habilitação: n. habilitation
habilitar	habilitar: enable
habitação	habitação: n. room
habitante	habitante: n. inhabitant
hábito	hábito: n. frock
habitual	habitual: adj. usual
habitualmente	habitualmente: adv. usually
harpa	harpa: n. harp
haver de	haver de: vbmod. have to
hectare	hectare: n.m. hectare
helicóptero	helicóptero: n. helicopter
hemisfério	hemisfério: n. hemisphere
heparina	heparina: n.f. heparin
herança	herança: n. estate, herança: n. inheritance
herdar	herdar: inherit
herói	herói: n. hero, herói: n. heroine
hierarquia	hierarquia: n. hierarchy
hino	hino: n. hymn
hipocrisia	hipocrisia: n. hypocrisy
hipotermia	hipotermia: n. hypothermia
hipótese	hipótese: n. hypothesis
historiador	historiador: n. historian
história	história: n. history, história: n. story
historicamente	historicamente: adv. historically
histórico	histórico: adj. historical
hoje	hoje: adv. today
holandês	holandês: n. Dutch
homem	homem: n. male, homem: n. man
homenagem	homenagem: n.f. homage
homicídio	homicídio: n. homicide
homologação	homologação: n. homologation
homossexual	homossexual: adj. homosexual
honra	honra: n.f. honor, honra: n.f. honour
honrar	honrar: honour
hora	hora: n. hour, hora: n. time
horário	horário: n. schedule, horário: n. timetable
horizonte	horizonte: n. horizon
hormona	hormona: n.f. hormone
hormônio	hormônio: n.m. hormone
horrível	horrível: adj.mf. frightful, horrível: adj. horrible
horror	horror: n. horror
hóspede	hóspede: n.mf. guest, hóspede: n.mf. hostess
hospital	hospital: n. hospital
hospitalização	hospitalização: n. hospitalization
hostil	hostil: adj. hostile
hostilidade	hostilidade: n. hostility
hotel	hotel: n. hotel
humanidade	humanidade: n. mankind
humanitário	humanitário: adj. humanitarian
humano	humano: adj. human
húmido	húmido: adj. humid, húmido: adj. wet
humilde	humilde: adj. humble
humildemente	humildemente: adv. humbly
humor	humor: n. humor, humor: n. humour, humor: n. mood
humorista	humorista: n. humorist
ibérico	ibérico: adj. Iberian
ibério	ibério: adj. Iberian
idade	idade: n. age
ideal	ideal: adj. ideal
idéia	idéia: n. idea
ideia	ideia: n. idea, ideia: n. insight, ideia: n. notion
idêntico	idêntico: adj. identical
identidade	identidade: n. identity
identificação	identificação: n. identification
identificar	identificar: identify
ideológico	ideológico: adj. ideological
idioma	idioma: n. language
idiota	idiota: n. idiot
ídolo	ídolo: n. idol
ignorância	ignorância: n. ignorance
ignorar	ignorar: ignore
igreja	igreja: n. church
igualdade	igualdade: n. equality
igual	igual: adj. equal, igual: adv. the same
igualmente	igualmente: adv. alike, igualmente: adv. equally
ilegal	ilegal: adj. illegal
ilegalmente	ilegalmente: adv. illegally
ilha	ilha: n. island
ilícito	ilícito: adj. illicit
ilimitado	ilimitado: adj. boundless
iluminar	iluminar: light
ilusão	ilusão: n. illusion
ilustração	ilustração: n. illustration
ilustrador	ilustrador: n. illustrator
ilustrar	ilustrar: illustrate
imagem	imagem: n. image
imaginar	imaginar: figure, imaginar: imagine
íman	íman: n. magnet
imediatamente	imediatamente: adv. at once, imediatamente: adv. immediately, imediatamente: adv. right off
imediato	imediato: adj. immediate
imenso	imenso: adj. immense
imigração	imigração: n. immigration
imigrante	imigrante: n. immigrant
iminente	iminente: adj. imminent
imitar	imitar: imitate
imobiliária	imobiliária: n. real estate
imortal	imortal: adj. immortal
imóvel	imóvel: adj. motionless
impaciência	impaciência: n. impatience
impacto	impacto: n. hit, impacto: n. impact
imparcial	imparcial: adj. impartial
impedir	impedir: preclude
imperador	imperador: n. emperor
império	império: n. empire
implantação	implantação: n. implantation
implantar	implantar: implant
implicar	implicar: imply, implicar: involve
impor	impor: impose
importação	importação: n. import
importância	importância: n. importance, importância: n. significance
importante	importante: adj. important, importante: adj. major, importante: adj. of note
importar	importar: import, importar: matter, importar: mind
impossível	impossível: adj. impossible
imposto	imposto: n. tax, imposto: n. taxation, imposto: n. taxation
impotente	impotente: adj. impotent, impotente: adj. powerless
imprensa	imprensa: n. press
impressão	impressão: n. footprint, impressão: n. impression, impressão: n. printing
impressionante	impressionante: adj. impressive, impressionante: adj. shocking
imprevisto	imprevisto: adj. unforeseen
improvável	improvável: adj. unlikely
improvisar	improvisar: improvise
impulso	impulso: n. boost, impulso: n. impetus, impulso: n. impulse, impulso: n. lift, impulso: n. urge
impunemente	impunemente: adv. with impunity
impunidade	impunidade: n. impunity
inaceitável	inaceitável: adj. unacceptable
inadmissível	inadmissível: adj. inadmissible
inalação	inalação: n. inhalation
inauguração	inauguração: n. inauguration
incapacidade	incapacidade: n. disability, incapacidade: n. inability
incapaz	incapaz: adj.mf.pl. incapable, incapaz: adj.mf.sg. incapable, incapaz: adj.mf.pl. unable, incapaz: adj.mf.sg. unable
incentivo	incentivo: n. incentive
incerteza	incerteza: n. uncertainty
incerto	incerto: adj. uncertain
incidente	incidente: n. incident
incitar	incitar: incite, incitar: prompt
inclinação	inclinação: n.f. inclination
inclinar	inclinar: incline
incluir	incluir: enclose, incluir: include
inclusivamente	inclusivamente: adv. included
inclusive	inclusive: adv. even, inclusive: adv. included
incompetência	incompetência: n. incompetence
incondicional	incondicional: adj. unconditional
incorporação	incorporação: n. incorporation
incorporar	incorporar: incorporate
incrível	incrível: adj. incredible
incrivelmente	incrivelmente: adv. incredibly, incrivelmente: adv. unbelievably
indefeso	indefeso: adj. defenceless
indefinido	indefinido: adj. indefinite
indemnização	indemnização: n. compensation
indenização	indenização: n. compensation
independência	independência: n. independence
independente	independente: adj. independent
independentemente	independentemente: adv. independently
indicação	indicação: n. indication
indicador	indicador: n. indicator
indicar	indicar: indicate
índice	índice: n. index, índice: n. rate, índice: n. rating
indiferente	indiferente: adj. indifferent
indígena	indígena: adj. native
indignação	indignação: n. indignation
índio	índio: adj. Indian
indirectamente	indirectamente: adv. indirectly
indiretamente	indiretamente: adv. indirectly
indispensável	indispensável: adj. indispensable
indistintamente	indistintamente: adv. indistinctly
individual	individual: adj. individual
individualmente	individualmente: adv. individually, individualmente: adv. on an individual basis
indivíduo	indivíduo: n. individual
indonésio	indonésio: adj. Indonesian
industria	industria: n. industry
indústria	indústria: n. industry
industrial	industrial: adj. industrial
industrializar	industrializar: industrialize
induzir	induzir: induce
inércia	inércia: n. inertia
inesperado	inesperado: adj. unexpected
inevitável	inevitável: adj. inevitable, inevitável: adj. unavoidable
inexplicavelmente	inexplicavelmente: adv. inexplicably
infância	infância: n. child
infante	infante: n. child
infantil	infantil: adj. childish
infecção	infecção: n. infection
infectar	infectar: infect
inferior	inferior: adj. bottom, inferior: adj. inferior
inferno	inferno: n. hell
infinito	infinito: n. infinite, infinito: adj. infinite
inflação	inflação: n. inflation
inflamável	inflamável: adj. flammable, inflamável: adj. inflammable
influência	influência: n. influence
influir	influir: influence
informação	informação: n. information
informal	informal: adj. informal
informar	informar: brief, informar: inform, informar: report
informativo	informativo: adj. informational, informativo: adj. informative
infra-estrutura	infra-estrutura: n. infrastructure
infrequente	infrequente: adj. infrequent
infreqüente	infreqüente: adj. infrequent
ingénuo	ingénuo: adj. naïve
ingênuo	ingênuo: adj. naïve
inglês	inglês: n. English, inglês: adj. English
ingresso	ingresso: n. income, ingresso: n. revenue
inicial	inicial: adj. initial
inicialmente	inicialmente: adv. initially
iniciar	iniciar: initiate, iniciar: pioneer
iniciativa	iniciativa: n. initiative
início	início: n. start
inimigo	inimigo: n. enemy
injustamente	injustamente: adv. unfairly
injustiça	injustiça: n. injustice
injusto	injusto: adj. unfair
inocência	inocência: n. innocence
inocente	inocente: adj. innocent
inovação	inovação: n. innovation
inovador	inovador: adj. innovative
inquérito	inquérito: n. interrogation
inquieto	inquieto: adj. restless
inquietude	inquietude: n. interest, inquietude: n. restlessness
insanidade	insanidade: n. insanity
inscrição	inscrição: n. registration
insecto	insecto: n. insect
insegurança	insegurança: n. insecurity
inseguro	inseguro: adj. unsure
inseto	inseto: n. insect
insignificante	insignificante: adj. insignificant, insignificante: adj. marginal
insistir	insistir: insist
insólito	insólito: adj. unusual
insónia	insónia: n.f. sleeplessness
insônia	insônia: n.f. sleeplessness
inspeção	inspeção: n. inspection
inspecção	inspecção: n. examination, inspecção: n. inspection
inspeccionar	inspeccionar: inspect
inspecionar	inspecionar: inspect
inspiração	inspiração: n. inspiration
inspirar	inspirar: inspire
instabilidade	instabilidade: n. unsteadiness
instalação	instalação: n. facility, instalação: n. installation
instalar	instalar: install, instalar: set up
instância	instância: n. instance
instante	instante: n. instant
instar	instar: urge
instável	instável: adj. unstable
instinto	instinto: n. instinct
institucional	institucional: adj. institutional
instituição	instituição: n. institution
instituto	instituto: n. high school, instituto: n. institute
instrução	instrução: n. instruction
instruir	instruir: instruct
instrumento	instrumento: n. instrument
insuficiente	insuficiente: adj. insufficient
insuficientemente	insuficientemente: adv. insufficiently
insultar	insultar: abuse
intacto	intacto: adj.m.sg. intact, intacto: adj.f.sg. intact, intacto: adj.m.pl. intact, intacto: adj.f.pl. intact, intacto: adj.GD.pl. intact, intacto: adj. intact
integração	integração: n. integration
integrar	integrar: integrate
integridade	integridade: n. integrity
inteiro	inteiro: adj. entire, inteiro: adj. whole
intelectual	intelectual: adj. intellectual
inteligência	inteligência: n. intelligence
inteligente	inteligente: adj. intelligent
intenção	intenção: n. intention
intensidade	intensidade: n. intensity
intensificar	intensificar: intensify
intensivo	intensivo: adj. intensive
intenso	intenso: adj. intense
interação	interação: n. interaction
interacção	interacção: n. interaction
interactivo	interactivo: adj. interactive
intercâmbio	intercâmbio: n. exchange
interceptar	interceptar: intercept
interessante	interessante: adj. interesting, interessante: adj. worthwhile
interesse	interesse: n. interest
interino	interino: adj. interim
interior	interior: n. inside, interior: n. interior, interior: adj. indoor, interior: adj. inner
interiormente	interiormente: adv. inwardly
interlocutor	interlocutor: n. speaker
internacional	internacional: adj. international
internet	internet: n. internet
interno	interno: adj. internal
interpor	interpor: interpose
interpretação	interpretação: n. interpretation, interpretação: n. performance
interpretar	interpretar: interpret, interpretar: play
intérprete	intérprete: n. interpreter, intérprete: n. performer, intérprete: n. player
interrogar	interrogar: interrogate
interrogatório	interrogatório: n. examination, interrogatório: n. interrogation
interromper	interromper: interrupt
interrupção	interrupção: n. interruption
intervalo	intervalo: n. interval
intervenção	intervenção: n. intervention
intervir	intervir: intervene, intervir: take part
intimidação	intimidação: n. intimidation
íntimo	íntimo: adj. intimate
intolerância	intolerância: n. intolerance
intolerável	intolerável: adj. intolerable
introduzir	introduzir: enter, introduzir: introduce
inumerável	inumerável: adj. innumerable
inúmero	inúmero: adj.m. countless, inúmero: adj.f. countless, inúmero: adj.GD. countless
inundação	inundação: n. flood, inundação: n. inundation
inundar	inundar: drown, inundar: flood, inundar: inundate
inútil	inútil: adj. useless
invasão	invasão: n. invasion
inveja	inveja: n. envy
invejar	invejar: envy
invenção	invenção: n. invention
inventar	inventar: invent
inventor	inventor: n. inventor
inverno	inverno: n. winter
inverso	inverso: adj. reverse
investidor	investidor: n. investor
investigação	investigação: n. enquiry, investigação: n. inquiry, investigação: n. investigation, investigação: n. research
investigar	investigar: investigate, investigar: research
investimento	investimento: n.m. investment
investir	investir: invest, investir: reverse
invisível	invisível: adj. invisible
invocar	invocar: invoke
involuntariamente	involuntariamente: adv. unintentionally
ira	ira: n. anger
iraniano	iraniano: adj. Iranian
iraquiano	iraquiano: adj. Iraqi
ir	ir: go, ir: proceed
irlandês	irlandês: n. Irish, irlandês: adj. Irish
irmão	irmão: n. brother, irmão: n. sister
irregularidade	irregularidade: n. irregularity
irregular	irregular: adj. irregular
irritação	irritação: n. irritation
islâmico	islâmico: adj. Islamic
isolar	isolar: isolate
israelense	israelense: n.mf. Israeli, israelense: adj.mf. Israeli
isso	isso: prn. this
isto é	isto é: adv. namely, isto é: adv. that is to say, isto é: adv. to wit
isto	isto: prn. this
italiano	italiano: n. Italian, italiano: adj. Italian
já	já: adv. already
jamais	jamais: adv. never
janeiro	janeiro: n. January
janela	janela: n. window
jantar	jantar: n.m. dinner
japonês	japonês: n. Japanese, japonês: adj. Japanese
já que	já que: cnjadv. for, já que: cnjadv. since
jardim	jardim: n. garden
jardineiro	jardineiro: n. gardener
jargão	jargão: n.m. slang
joelho	joelho: n.m. knee
jogador	jogador: n. player
jogar	jogar: play, jogar: throw
jogo	jogo: n. gambling, jogo: n. game, jogo: n. play
jóia	jóia: n. jewel, jóia: n. jewellery, jóia: n. jewellery, jóia: n. jewelry, jóia: n. jewelry
jornada	jornada: n. day
jornalismo	jornalismo: n. journalism
jornalista	jornalista: n. journalist
jornalístico	jornalístico: adj. journalistic
jornal	jornal: n. diary, jornal: n. newspaper
jovem	jovem: n. junior, jovem: n. youngster, jovem: adj. young
judeu	judeu: adj. Jewish
judicial	judicial: adj. judicial
judiciário	judiciário: adj.m. judicial, judiciário: adj.f. judicial
juiz	juiz: n. judge
julgamento	julgamento: n. judgement, julgamento: n. judgment, julgamento: n. trial
julgar	julgar: judge
julho	julho: n. July
junho	junho: n. June
junta	junta: n. board, junta: n. joint
juntamente	juntamente: adv. jointly
juntar	juntar: joint
junto	junto: adj. together
jurar	jurar: swear
jurídico	jurídico: adj. juridical
júri	júri: n. jury
juro	juro: n. interest
justamente	justamente: adv. precisely
justiça	justiça: n. justice
justificação	justificação: n. justification
justificar	justificar: justify
justificativa	justificativa: n. justification
justo	justo: adj. fair, justo: adj. just, justo: adv. just
juvenil	juvenil: adj. juvenile
juventude	juventude: n. youth
kg	kg: n. kg
kilo	kilo: n. kilo
km	km: n. km
lábio	lábio: n. lip
laboral	laboral: adj. labour, laboral: adj. occupational
laboratório	laboratório: n. lab, laboratório: n. laboratory
laço	laço: n. noose
lado	lado: n. side
ladrão	ladrão: n.GD. thief, ladrão: n.f. thief, ladrão: n.m. thief
lago	lago: n. lake
lágrima	lágrima: n. tear
laicismo	laicismo: n. laicism
lá	lá: adv. there
lamentar	lamentar: regret
lamentável	lamentável: adj. regrettable
lançamento	lançamento: n. launch
lançar	lançar: cast, lançar: launch, lançar: sling
largo	largo: adj.m.sg. broad, largo: adj.f.sg. broad, largo: adj.GD.pl. broad, largo: adj. broad, largo: adj.m.sg. wide, largo: adj.f.sg. wide, largo: adj.m.pl. wide, largo: adj.f.pl. wide, largo: adj.GD.pl. wide, largo: adj. wide
largura	largura: n. width
lar	lar: n.m. home
laser	laser: n. laser
lástima	lástima: n. pity, lástima: n. pity
lateral	lateral: adj. lateral
latino	latino: n. Latin, latino: adj. Latin
lavar	lavar: wash
lavrar	lavrar: plough
leão	leão: n. lion
legalidade	legalidade: n. lawfulness
legalizar	legalizar: legalize
legal	legal: adj. legal
legalmente	legalmente: adv. legally
legar	legar: bequeath
legislação	legislação: n. legislation
legislador	legislador: n. legislator
legislativo	legislativo: adj. legislative
legislatura	legislatura: n. legislature
legitimamente	legitimamente: adv. legitimately
legitimidade	legitimidade: n. legitimacy
legítimo	legítimo: adj. legitimate
leilão	leilão: n.m. auction
lei	lei: n. act, lei: n. law
leite	leite: n.m. milk
leito	leito: n. mulch
leitor	leitor: n. reader
leitura	leitura: n. reading
lema	lema: n. lemma
lembrar	lembrar: agree
lenço	lenço: n. tissue
lenda	lenda: n. legend
lenha	lenha: n. firewood
lentamente	lentamente: adv. slowly
lente	lente: n. lens
lentidão	lentidão: n. slowness
lento	lento: adj. slow
leque	leque: n. fan
ler	ler: read
lesão	lesão: n. injury
lestamente	lestamente: adv. slightly
letal	letal: adj. lethal
letra	letra: n. handwriting, letra: n. letter, letra: n. lyric
letreiro	letreiro: n. label
leucemia	leucemia: n. leukaemia
levantar	levantar: erect, levantar: raise
levar	levar: bring, levar: carry
leve	leve: adj. slight
levianamente	levianamente: adv. slightly
libanês	libanês: adj. Lebanese
liberalismo	liberalismo: n. liberalism
liberal	liberal: adj. liberal
liberar	liberar: discharge, liberar: free, liberar: release
liberdade	liberdade: n. freedom
libertação	libertação: n.f. release
libertar	libertar: free
lição	lição: n. lesson
licença	licença: n. licence, licença: n. license
lícito	lícito: adj. lawful, lícito: adj. licit
lida	lida: n.f. job, lida: n.f. work
liderança	liderança: n.f. leadership
líder	líder: n. leader
ligação	ligação: n. connection
ligar	ligar: connect
ligeiramente	ligeiramente: adv. lightly, ligeiramente: adv. slightly
ligeiro	ligeiro: adj. light, ligeiro: adj. lightweight
limiar	limiar: n. threshold
limitação	limitação: n. limitation
limitar	limitar: confine, limitar: limit
limite	limite: n. limit
limpar	limpar: clean, limpar: clear
limpeza	limpeza: n. cleaning
limpo	limpo: adj. clean, limpo: adj. net
língua	língua: n. language, língua: n. tongue
linguístico	linguístico: adj. linguistic
lingüístico	lingüístico: adj. linguistic
linha	linha: n. line
líquido	líquido: n. liquid, líquido: adj. liquid
listagem	listagem: n.f. listing
lista	lista: n. list
listar	listar: list
liteira	liteira: n. bunk
literalmente	literalmente: adv. literally
literário	literário: adj. literary
literatura	literatura: n. literature
litoral	litoral: adj. littoral, litoral: adj. longshore
litro	litro: n. liter, litro: n. litre
livraria	livraria: n. bookshop
livrar	livrar: rid
livre	livre: adj. free
livremente	livremente: adv. freely
livro	livro: n. book
lixo	lixo: n.m.sg. garbage, lixo: n.m.sg. garbage, lixo: n.m.sg. rubbish, lixo: n.m.pl. rubbish
localidade	localidade: n. seat, localidade: n. town
localização	localização: n. location
localizar	localizar: locate, localizar: trace
local	local: n. venue, local: adj. local
lógica	lógica: n. logic
logicamente	logicamente: adv. logically
lógico	lógico: adj. logical
logístico	logístico: adj. logistical
logo	logo: cnjadv. therefore, logo: adv. immediately
loja	loja: n. shop, loja: n. store
longe	longe: adv. far
longínquo	longínquo: adj. far
longitude	longitude: n. length
longo	longo: adj. lengthy, longo: adj. long
louco	louco: adj. crazy, louco: adj. mad
lua	lua: n. moon
lucro	lucro: n. attainment, lucro: n. lucre
lugar	lugar: n. place, lugar: n. site, lugar: n. spot
lume	lume: n.m. flame, lume: n.m. llama
luminoso	luminoso: adj. ligthful, luminoso: adj. luminous
lustre	lustre: n.m. lamp, lustre: n.m. light
luta	luta: n. fight, luta: n. struggle
lutar	lutar: fight, lutar: struggle
luto	luto: n. deceit
luva	luva: n.f. glove
luxo	luxo: n. luxury
luz	luz: n.f. lamp, luz: n.f. light
maçã	maçã: n. apple
machado	machado: n.m. axe
macieza	macieza: n. softness
macio	macio: adj. soft
madeira	madeira: n. wood
madrugada	madrugada: n. morning
madurar	madurar: mature
maduro	maduro: adj. mature, maduro: adj. ripe
mãe	mãe: n. mother
maestro	maestro: n.m.sg. master, maestro: n.f.sg. master, maestro: n.GD.pl. master, maestro: n.m.pl. master, maestro: n.f.pl. master, maestro: n.m.sg. master, maestro: n.f.sg. master, maestro: n.m.pl. master, maestro: n.f.pl. master, maestro: n.GD.pl. master, maestro: n.mf. teacher
máfia	máfia: n. mafia
magia	magia: n. magic
mágico	mágico: adj. magic
magistrado	magistrado: n. magistrate
magnata	magnata: n. tycoon
magnético	magnético: adj. magnetic
magnífico	magnífico: adj. glorious, magnífico: adj. magnificent, magnífico: adj. superb
magnitude	magnitude: n. magnitude
mago	mago: n. magician
maio	maio: n. May
maioria	maioria: n. majority
maioritariamente	maioritariamente: adv. for the most part, maioritariamente: adv. mostly
maior	maior: adj. great, maior: adj. main
mais cedo ou mais tarde	mais cedo ou mais tarde: adv. sooner or later
mais	mais: adv. any more, mais: adv. best, mais: adv. else, mais: adv. more, mais: adv. most
mais tarde	mais tarde: adv. by and by, mais tarde: adv. later, mais tarde: adv. later on
mala	mala: n. case, mala: n. suitcase
maldade	maldade: n. maliciousness
maldição	maldição: n. curse
maldito	maldito: adj. fucking
mal-estar	mal-estar: n. unrest
maleta	maleta: n. suitcase
maligno	maligno: adj. malignant
mal	mal: n. evil, mal: n. harm, mal: adv. badly, mal: adv. wrong
maltratar	maltratar: abuse
mancha	mancha: n. spot, mancha: n. stain
manchar	manchar: mark
manchete	manchete: n.m. holder
mandar	mandar: command
mandatário	mandatário: n. mandator
mandato	mandato: n. mandate
maneira	maneira: n. fashion, maneira: n. manner, maneira: n. manner, maneira: n. way, maneira: n. way
manejar	manejar: handle, manejar: operate
manhã	manhã: n.f. morning
manifestação	manifestação: n. demonstration
manifestante	manifestante: n. demonstrator
manifestar	manifestar: manifest
manifesto	manifesto: n. manifesto
manipulação	manipulação: n. manipulation
manipular	manipular: manipulate
manobra	manobra: n. manoeuvre
mansão	mansão: n. mansion
manter	manter: keep, manter: maintain
manto	manto: n. mantle
manuscrito	manuscrito: n. manuscript, manuscrito: adj. handwritten
manutenção	manutenção: n.f. maintenance
mão	mão: n. hand
mapa	mapa: n. chart, mapa: n. map
máquina	máquina: n. machine
maquinaria	maquinaria: n. machinery
maratona	maratona: n.f. marathon
maravilha	maravilha: n.f. wonder
maravilhoso	maravilhoso: adj. marvellous, maravilhoso: adj. wonderful
marca	marca: n. brand, marca: n. make, marca: n. mark, marca: n. trademark
marcar	marcar: mark, marcar: score
marcha	marcha: n. gear, marcha: n. march
marchar	marchar: leave
marco	marco: n. frame, marco: n. framework
março	março: n. March
maré	maré: n. tide
margem	margem: n.f. margin
marido	marido: n. husband
marinheiro	marinheiro: n. sailor
marinho	marinho: adj. marine
marítimo	marítimo: adj. maritime
marketing	marketing: n.m.sg. marketing
mar	mar: n.m. sea
marroquino	marroquino: adj. Moroccan
martírio	martírio: n. martyrdom
marxista	marxista: adj. Marxist
máscara	máscara: n. mask
masculino	masculino: adj. masculine
mas	mas: cnjcoo. but
massa	massa: n. mass, massa: n. mass
matar	matar: kill
matemático	matemático: adj. mathematical
material	material: n. material, material: n. stuff, material: adj. material
matéria	matéria: n. matter, matéria: n. subject, matéria: n. matter
maternidade	maternidade: n. motherhood
matiz	matiz: n. nuance
maturidade	maturidade: n. maturity
maturo	maturo: adj. mature
mau	mau: adj. bad, mau: adj. mean, mau: adj. nasty
mau-trato	mau-trato: n. maltreatment
máximo	máximo: adj. maximal, máximo: adj. maximum
mecânico	mecânico: adj. mechanical
mecanismo	mecanismo: n. machinery, mecanismo: n. mechanism
medalha	medalha: n. medal
mediação	mediação: n. mediation
média	média: n. average
mediante	mediante: pr. by means of
medicamento	medicamento: n. medicine
medicina	medicina: n. medicine
médico	médico: n.f. doctor, médico: n.m. doctor, médico: adj. medical
medida	medida: n. measure, medida: n. measurement, medida: n. size
médio	médio: adj. average, médio: adj. half
medir	medir: measure
medo	medo: n.m. fear
meia	meia: n.f. average, meia: n.f. sock
meia-noite	meia-noite: n. midnight
meigo	meigo: adj. tender
meio dia	meio dia: n. midday, meio dia: n. noon
meio	meio: n. environment, meio: n. means, meio: n. surroundings
melancólico	melancólico: adj. melancholic
melhora	melhora: n. improvement
melhorar	melhorar: improve
melhor	melhor: adj. good, melhor: adj. good
mel	mel: n.m. honey
membro	membro: n. fellow, membro: n. member
memória	memória: n. memory
menção	menção: n.f. quotation
mencionar	mencionar: mention
menino	menino: n. boy, menino: n. child, menino: n. girl, menino: n. infant, menino: n. kid
menor	menor: n. minor, menor: adj. lesser, menor: adj. minor
menos	menos: adv. least, menos: adv. less
mensageiro	mensageiro: n. messenger
mensagem	mensagem: n.f. message
mensal	mensal: adj. monthly
mentalidade	mentalidade: n. mentality
mental	mental: adj. mental
mentalmente	mentalmente: adv. mentally
mente	mente: n. mind
mentira	mentira: n. lie
meramente	meramente: adv. merely
mercado	mercado: n. market
mercadoria	mercadoria: n. commodity
mercantil	mercantil: adj. mercantile
merecer	merecer: deserve
mérito	mérito: n. merit
mesa	mesa: n. table
mês	mês: n. month
mesmo assim	mesmo assim: cnjadv. yet
mesmo	mesmo: adj. same, mesmo: adv. still, mesmo: adv. yet
mesmo que	mesmo que: cnjadv. although
metade	metade: n. half
metáfora	metáfora: n. metaphor
metálico	metálico: adj. metallic
metal	metal: n. metal
meta	meta: n.f. milestone
método	método: n. method
metrô	metrô: n. metre
metro	metro: n. metre, metro: n. subway, metro: n. tube
metropolitano	metropolitano: adj. metropolitan
meu	meu: det. my, meu: adj. mine
mexicano	mexicano: adj. Mexican
microfone	microfone: n. microphone
milagre	milagre: n. miracle
milénio	milénio: n. millennium
milênio	milênio: n. millennium
milha	milha: n. mile
milhão	milhão: n. million
milhar	milhar: num.mf.pl. ten hundred, milhar: num.mf.pl. thousand
milionário	milionário: n. millionaire
militante	militante: n. militant
militar	militar: adj. military
mil	mil: num.mf.sg. ten hundred, mil: num.mf.sg. thousand
mim	mim: prn. prpers
mina	mina: n. mine
mineiro	mineiro: n. miner
mínimo	mínimo: adj. minimal, mínimo: adj. minimum
ministerial	ministerial: adj. ministerial
ministério	ministério: n. ministry
ministro	ministro: n.m.sg. minister, ministro: n.f.sg. minister, ministro: n.GD.pl. minister, ministro: n.m.pl. minister, ministro: n.f.pl. minister, ministro: n.m.sg. minister, ministro: n.f.sg. minister, ministro: n.m.pl. minister, ministro: n.f.pl. minister, ministro: n.GD.pl. minister
minoritário	minoritário: adj. minoritary
minuto	minuto: n. minute
mirada	mirada: n.f. glance, mirada: n.f. look
miséria	miséria: n. pittance
missão	missão: n. mission
mistério	mistério: n. mystery
misterioso	misterioso: adj. mysterious
misto	misto: adj. mixed
mistura	mistura: n. melange, mistura: n. mix
misturar	misturar: mix
mítico	mítico: adj. mythical
mito	mito: n. myth
mobilização	mobilização: n. mobilization
moção	moção: n. motion
moço	moço: n. boy, moço: n. girl, moço: n. lad
modal	modal: adj. modal
moda	moda: n. fashion, moda: n. mode
modelo	modelo: n. model
moderar	moderar: moderate
modernização	modernização: n. modernization
moderno	moderno: adj. modern, moderno: adj. state-of-the-art
modesto	modesto: adj. modest
modificação	modificação: n. modification
modificar	modificar: modify
modo	modo: n.m. manner, modo: n.m. mode, modo: n.m. mood, modo: n.m. way
módulo	módulo: n. module
moeda	moeda: n. coin, moeda: n. currency
molécula	molécula: n. molecule
molestar	molestar: bother
molesto	molesto: adj. annoying
momento	momento: n. moment, momento: n.m. while
monarca	monarca: n. monarch
monetário	monetário: adj. monetary
monge	monge: n. monk
monopólio	monopólio: n. monopoly
monstro	monstro: n. monster
montanha	montanha: n. mountain
montante	montante: n. strut
montar	montar: mount, montar: set up
monte	monte: n. mount, monte: n.m. mountain
monumento	monumento: n. monument
moradia	moradia: n.f. house
morador	morador: n.m. inhabitant, morador: n.f. inhabitant
moralmente	moralmente: adv. morally
moral	moral: adj. moral
morar	morar: live
morder	morder: bite
morno	morno: adj. warm
morrer	morrer: die
mortalidade	mortalidade: n. mortality
mortal	mortal: adj. mortal
morteiro	morteiro: n. mortar
morte	morte: n.f. dead person, morte: n.f. death, morte: n.f. demise, morte: n.f. passing
morto	morto: adj. dead
mosca	mosca: n. fly
mosquito	mosquito: n. mosquito
mostra	mostra: n. sample
mostrar	mostrar: display, mostrar: show
mota	mota: n. motorbike
motivação	motivação: n. motivation
motivar	motivar: motivate
motivo	motivo: n. reason
moto	moto: n. motorbike
motorista	motorista: n.mf. driver
motor	motor: n. engine, motor: n. motor
móvel	móvel: adj. mobile, móvel: adj. removable
mover	mover: move, mover: shift
movimentar	movimentar: move
movimento	movimento: n. motion, movimento: n. move, movimento: n. movement
muçulmano	muçulmano: adj. Muslim
mudança	mudança: n.f. change, mudança: n.f. exchange, mudança: n.f. shift, mudança: n.f. swing, mudança: n.f. switch
mudar	mudar: capsize, mudar: change, mudar: shift
muito	muito: preadv. any, muito: preadv. very, muito: adv. a lot, muito: adv. awfully, muito: adv. dearly, muito: adv. greatly, muito: adv. hugely, muito: adv. much, muito: adv. very much
mulher	mulher: n. female, mulher: n. wife, mulher: n. woman
multa	multa: n. fine
multidão	multidão: n. crowd
multinacional	multinacional: n. multinational
multiplicar	multiplicar: multiply
múltiplo	múltiplo: adj.GD. multiple, múltiplo: adj.f. multiple, múltiplo: adj.m. multiple
mundial	mundial: adj. world, mundial: adj. world-wide
mundo	mundo: n. world
municipal	municipal: adj. municipal
município	município: n. municipality
muralha	muralha: n. rampart, muralha: n. wall
murmurar	murmurar: mutter
músculo	músculo: n. muscle
museu	museu: n. museum
musical	musical: adj. musical
músico	músico: n. musician
mútuo	mútuo: adj. mutual
nação	nação: n. nation
nacionalidade	nacionalidade: n. nationality
nacionalismo	nacionalismo: n. nationalism
nacional	nacional: adj. national
na contramão	na contramão: adv. against, na contramão: adv. vs
nada	nada: prn.tn.nt. anything, nada: prn.tn.nt. nothing, nada: adv. at all
nadar	nadar: swim
namorado	namorado: n. bridegroom
não	não: adv. no, não: adv. non, não: adv. not
nariz	nariz: n.m. nose
narrativo	narrativo: adj. narrative
nascer	nascer: be born
nascimento	nascimento: n. birth
natal	natal: adj. natal
naturalmente	naturalmente: adv. naturally, naturalmente: adv. of course
natural	natural: adj. natural
natureza	natureza: n. nature
naufrágio	naufrágio: n. shipwreck
naval	naval: adj. naval
navegação	navegação: n. navigation, navegação: n. sailing
navegante	navegante: n. seafarer
navegar	navegar: sail
nave	nave: n. building, nave: n. nave, nave: n. ship
navio	navio: n. fuselage
nazismo	nazismo: n. Nazism
necessariamente	necessariamente: adv. necessarily
necessário	necessário: adj. necessary
necessidade	necessidade: n. need
negar	negar: deny
negativa	negativa: n. refusal
negativo	negativo: adj. negative
negociação	negociação: n. negotiation
negociar	negociar: negotiate
negócio	negócio: n. bargain, negócio: n. business
negro	negro: n.m.sg. black, negro: n.f.sg. black, negro: n.GD.pl. black, negro: n.m.pl. black, negro: n.f.pl. black, negro: n.m.sg. black, negro: n.f.sg. black, negro: n.m.pl. black, negro: n.f.pl. black, negro: n.GD.pl. black, negro: adj.m.sg. black, negro: adj.f.sg. black, negro: adj.m.pl. black, negro: adj.f.pl. black, negro: adj.GD.pl. black, negro: adj. black
nem	nem: cnjcoo. neither, nem: cnjcoo. nor, nem: cnjcoo. or
nenhum	nenhum: det.ind.f.sg. any, nenhum: det.ind.m.sg. any, nenhum: det.ind.GD. either, nenhum: det.ind.GD. no, nenhum: prn.tn.m.sg. any, nenhum: prn.tn.f.sg. any, nenhum: prn.tn.m.pl. any, nenhum: prn.tn.f.pl. any, nenhum: prn.tn.GD. either, nenhum: prn.tn.GD. none
nen que	nen que: cnjadv. although
nervo	nervo: n. nerve
nervosismo	nervosismo: n. anxiety
nervoso	nervoso: adj. nervous
neto	neto: n. grandchild, neto: n. granddaughter, neto: n. grandson, neto: adj. clean
neurónio	neurónio: n.m. neuron
neurônio	neurônio: n.m. neuron
neutralizar	neutralizar: neutralize
neve	neve: n. snow
nigeriano	nigeriano: adj. Nigerian
ninguém	ninguém: prn.tn.mf.sg. anybody, ninguém: prn.tn.mf.sg. anyone, ninguém: prn.tn.mf.sg. no one, ninguém: prn.tn.mf.sg. nobody
ninho	ninho: n. nest
nível	nível: n. level
no alto	no alto: adv. above
nobre	nobre: adj. noble
nobreza	nobreza: n. nobility
nocturno	nocturno: adj. nocturnal
nodo	nodo: n. knot
noite	noite: n.f. evening, noite: n. night
noivo	noivo: n. bridegroom
no mais tardar	no mais tardar: adv. at the latest
no máximo	no máximo: adv. at most, no máximo: adv. at the maximum, no máximo: adv. at the most, no máximo: adv. at the very most
nomeação	nomeação: n.f. nomination
nomeadamente	nomeadamente: adv. on purpose
nomear	nomear: appoint, nomear: nominate
no meio	no meio: adv. in between, no meio: adv. in the middle
nome	nome: n. name
no mínimo	no mínimo: adv. at least
no ponto	no ponto: adv. at the point
no que diz respeito a	no que diz respeito a: pr. regarding
normalidade	normalidade: n. normality
normalização	normalização: n. normalization
normalmente	normalmente: adv. normally, normalmente: adv. ordinarily, normalmente: adv. usually
normal	normal: adj. normal, normal: adj. ordinary
norma	norma: n. norm
normativo	normativo: adj. normative
noroeste	noroeste: n. northwest
norte	norte: n. north
nosso	nosso: det. our, nosso: adj.pos.m.sg. ours, nosso: adj.pos.f.sg. ours, nosso: adj.pos.m.pl. ours, nosso: adj.pos.f.pl. ours
nostalgia	nostalgia: n. nostalgia
notadamente	notadamente: adv. mainly
nota	nota: n. grade, nota: n. note
notário	notário: n. notary
notar	notar: sense
notavelmente	notavelmente: adv. notably
notável	notável: adj. notable, notável: adj. remarkable
notícia	notícia: n. news
noticiar	noticiar: inform
noticioso	noticioso: adj. informative
noturno	noturno: adj. nocturnal
novamente	novamente: adv. again, novamente: adv. newly
novela	novela: n. novel
novembro	novembro: n. November
novidade	novidade: n. novelty
novo	novo: adj. new
noz	noz: n. walnut
nuca	nuca: n.f. nape
nuclear	nuclear: adj. nuclear
núcleo	núcleo: n. core, núcleo: n. nucleus
número	número: n. number
numeroso	numeroso: adj. numerous
nunca	nunca: adv. ever, nunca: adv. never
nutrir	nutrir: nourish
nuvem	nuvem: n.f. cloud
obedecer	obedecer: obey
obediência	obediência: n. obedience
objectivo	objectivo: n.m. aim, objectivo: n.m. goal, objectivo: n.m. object, objectivo: n.m. objective, objectivo: n.m. target, objectivo: adj. objective
objecto	objecto: n. object
objetivo	objetivo: n.m. aim, objetivo: adj. objective
objeto	objeto: n. object
obra	obra: n. drama, obra: n. work
obrigação	obrigação: n. obligation
obrigar	obrigar: bind, obrigar: force
obrigatório	obrigatório: adj. binding, obrigatório: adj. compulsory
observação	observação: n. observation
observador	observador: n. observer
observar	observar: observe
obstáculo	obstáculo: n. fence, obstáculo: n. obstacle
obstinação	obstinação: n. obstinacy
obter	obter: gain, obter: obtain, obter: raise
obviamente	obviamente: adv. obviously
óbvio	óbvio: adj. obvious
oca	oca: n. cave
ocasião	ocasião: n. occasion
ocasionalmente	ocasionalmente: adv. occasionally
ocasional	ocasional: adj. occasional
oceano	oceano: n. ocean
ocidental	ocidental: adj. occidental, ocidental: adj. western
ocidente	ocidente: n. occident
oco	oco: n. gap
ocorrer	ocorrer: occur
ocultar	ocultar: secrete
oculto	oculto: adj. unseen
ocupação	ocupação: n.f. employment, ocupação: n.f. occupation
ocupante	ocupante: n. occupant
ocupar	ocupar: occupy
odiar	odiar: hate
ódio	ódio: n. hate
oeste	oeste: n. west
ofender	ofender: offend
ofensa	ofensa: n. offence
ofensivo	ofensivo: adj. offensive
oferecer	oferecer: offer
oferta	oferta: n. bid, oferta: n. offer, oferta: n. tender
oficialmente	oficialmente: adv. officially, oficialmente: adv. on record
oficial	oficial: n. official, oficial: adj. official
oficina	oficina: n.f. workshop
oh	oh: ij. oh
oi	oi: ij. hello
olá	olá: ij. hello
óleo	óleo: n. oil
olfacto	olfacto: n. smell
olfato	olfato: n. smell
olhador	olhador: n. oriel
olhar	olhar: glance, olhar: look, olhar: watch
olho	olho: n. eye
olímpico	olímpico: adj. olympic
ombreira	ombreira: n.f. threshold
o meu	o meu: det. my, o meu: det. my, o meu: prn. mine, o meu: prn. mine
onda	onda: n. wave
onde	onde: rel.adv. where, onde: adv. where
ónibus	ónibus: n.m.sp. bus
ônibus	ônibus: n.m.sp. bus
o nosso	o nosso: det. our, o nosso: det. our, o nosso: prn. ours, o nosso: prn. ours
ontem	ontem: adv. yesterday
ónus	ónus: n.m.sp. burden, ónus: n.m.sp. charge, ónus: n.m.sp. load
onze	onze: num. eleven
opaco	opaco: adj. opaque
opção	opção: n. option
operação	operação: n. operation
operador	operador: n. operator
ópera	ópera: n. opera
operar	operar: operate
operativo	operativo: adj. operating, operativo: adj. operative
opinar	opinar: think
opinião	opinião: n. opinion
oportunidade	oportunidade: n. chance, oportunidade: n. opportunity
oportuno	oportuno: adj. timely
oposição	oposição: n. opposition
optar	optar: opt
optimismo	optimismo: n. optimism
optimista	optimista: adj. optimistic
optimizar	optimizar: optimize
óptimo	óptimo: adj. optimum
o qual	o qual: rel. which
o que	o que: rel. which
oração	oração: n. prayer
órbita	órbita: n. orbit
orçamental	orçamental: adj.mf. budgetary
orçamentário	orçamentário: adj. budgetary
orçamento	orçamento: n.m. budget, orçamento: n.m. estimate
ordem	ordem: n.f. command, ordem: n.f. order
ordenar	ordenar: order, ordenar: sort
orelha	orelha: n. ear
orgânico	orgânico: adj. organic
organismo	organismo: n. organism
organização	organização: n. organisation, organização: n. organization
organizador	organizador: n. organizer
organizar	organizar: organise, organizar: organize
órgão	órgão: n. organ
orgulho	orgulho: n. pride
orgulhoso	orgulhoso: adj. proud
orientação	orientação: n. orientation
oriental	oriental: adj. eastern, oriental: adj. oriental
origem	origem: n.f. origin
original	original: adj. original
originar	originar: originate
orla	orla: n. bank
o seu	o seu: det. her, o seu: det. his, o seu: det. his, o seu: det. its, o seu: det. their, o seu: prn. hers, o seu: prn. his, o seu: prn. his, o seu: prn. theirs
ósseo	ósseo: adj. osseous
osso	osso: n. bone, osso: n. stone
o tempo todo	o tempo todo: adv. all the while, o tempo todo: adv. the whole while
o teu	o teu: det. your, o teu: prn. yours
otimismo	otimismo: n. optimism
otimista	otimista: adj. optimistic
otimizar	otimizar: optimize
ótimo	ótimo: adj. optimum
ou	ou: cnjcoo. either, ou: cnjcoo. or
ouro	ouro: n. gold
ousar	ousar: dare
outono	outono: n.m. autumn
outorgar	outorgar: award
outro	outro: det. another, outro: det.ind.f.sg. another, outro: det.ind.m.sg. another, outro: det.ind.f.sg. other, outro: det.ind.m.sg. other, outro: det.ind.GD.pl. other, outro: det.ind.f.sg. other, outro: det.ind.m.sg. other, outro: det.ind.m.pl. other, outro: det.ind.f.pl. other, outro: prn. another, outro: prn. another one, outro: prn. others
outubro	outubro: n. October
ouvido	ouvido: n.m. hearing
ouvir	ouvir: listen
ovelha	ovelha: n. sheep
ovo	ovo: n. egg
o vosso	o vosso: det. your, o vosso: det. your, o vosso: prn. yours, o vosso: prn. yours
oxigénio	oxigénio: n. oxygen
ozónio	ozónio: n. ozone
ozônio	ozônio: n. ozone
paciência	paciência: n. patience
pacientemente	pacientemente: adv. patiently
paciente	paciente: n. patient, paciente: adj. patient
pacífico	pacífico: adj. peaceful
pacote	pacote: n.m. pack, pacote: n.m. package, pacote: n.m. packet
pacto	pacto: n. pact
padecer	padecer: suffer
padre	padre: n. father, padre: n. parent
pagamento	pagamento: n. payment
pagar	pagar: pay
página	página: n. page
painel	painel: n. signpost
pai	pai: n. father, pai: n. father, pai: n. parent, pai: n. parent, pai: n. father
paisagem	paisagem: n.f. landscape
país	país: n. country
paixão	paixão: n. passion
palácio	palácio: n. palace
palavra	palavra: n. word
palco	palco: n. stage
palestiniano	palestiniano: n. Palestinian, palestiniano: adj. Palestinian
palestino	palestino: n. Palestinian, palestino: adj. Palestinian
palestrante	palestrante: n. speaker
pálido	pálido: adj. pale
pálpebra	pálpebra: n.f. lid
pânico	pânico: n. panic
panorama	panorama: n. panorama
pantera	pantera: n. panther
pão	pão: n. bread
papai	papai: n. dad, papai: n. daddy
papa	papa: n. pope
papel	papel: n. paper
para além	para além: adv. beyond, para além: adv. further
paradoxalmente	paradoxalmente: adv. paradoxically
parágrafo	parágrafo: n. paragraph
paraguaio	paraguaio: adj. Paraguayan
paralelo	paralelo: adj. parallel
paralisar	paralisar: paralyze
para	para: pr. for, para: pr. towards
parar	parar: halt, parar: pause, parar: stop
parcialmente	parcialmente: adv. partially
parcial	parcial: adj. partial
parecer	parecer: appear, parecer: feel, parecer: look, parecer: look like, parecer: seem
parede	parede: n. wall
parente	parente: n. relative
paridade	paridade: n. parity
parlamentar	parlamentar: adj.mf. parliamentary
parlamento	parlamento: n. parliament
par	par: n. couple, par: n. pair
parque	parque: n. park
parte	parte: n.f. part
participação	participação: n. participation, participação: n. share, participação: n. stake
participante	participante: n. participant
participar	participar: participate, participar: take part
partícula	partícula: n. particle
particularmente	particularmente: adv. particularly
particular	particular: adj. particular
partido	partido: n. match, partido: n. party
partilha	partilha: n.f. cast, partilha: n.f. distribution
partilhar	partilhar: divide
partir	partir: split
passado	passado: n. past, passado: adj. past
passagem	passagem: n.f. passage
passaporte	passaporte: n. passport
pássaro	pássaro: n. bird
passar	passar: happen, passar: pass, passar: spend
passeata	passeata: n. gear, passeata: n. march
passeio	passeio: n. drive, passeio: n. promenade, passeio: n. ride, passeio: n. walk
passo	passo: n.m. pace, passo: n.m. passage, passo: n.m. passing, passo: n.m. step
pasta	pasta: n. folder, pasta: n. portfolio
pastor	pastor: n. shepherd
pátio	pátio: n. courtyard, pátio: n. playground, pátio: n. yard
patrão	patrão: n. master, patrão: n. pattern
pátria	pátria: n. homeland
patriarca	patriarca: n. patriarch
património	património: n. heritage
patrimônio	patrimônio: n. heritage
patrocinar	patrocinar: sponsor
patrulha	patrulha: n. patrol
pau	pau: n. pole, pau: n. post, pau: n. stick
pausa	pausa: n. pause
paz	paz: n. peace
peça	peça: n. piece
pecar	pecar: sin
pedaço	pedaço: n. chip, pedaço: n. lump, pedaço: n. piece
pedir	pedir: ask, pedir: ask for, pedir: call for, pedir: request
pedreiro	pedreiro: n. bricklayer
pegar	pegar: catch, pegar: get, pegar: grasp, pegar: pick up, pegar: reach for, pegar: take
peito	peito: n. breast, peito: n. chest
peixe	peixe: n. fish
pejo	pejo: n. stink
pelar	pelar: peel
pele	pele: n.f. fur, pele: n.f. leather, pele: n.f. skin
película	película: n. film, película: n. movie
pelota	pelota: n. ball
penal	penal: adj. penal
pena	pena: n. penalty, pena: n. pity
pendente	pendente: n. slope
pender	pender: hang
pendurar	pendurar: hang
penetrar	penetrar: penetrate
península	península: n. peninsula
penitência	penitência: n. penance
pensamento	pensamento: n. thinking, pensamento: n. thought
pensão	pensão: n. allowance, pensão: n. guesthouse, pensão: n. pension
pensar	pensar: think
pé	pé: n. foot
pequeno	pequeno: adj. little, pequeno: adj. small
perante	perante: pr. in front of
perceber	perceber: perceive
percentagem	percentagem: n.f. percent, percentagem: n.f. percentage
percorrer	percorrer: resort
percurso	percurso: n. route
percussão	percussão: n. percussion
perdão	perdão: n. pardon
perda	perda: n.f. loss
perder	perder: lose, perder: miss
perdoar	perdoar: forgive
peregrino	peregrino: n. pilgrim
perfeitamente	perfeitamente: adv. flawlessly, perfeitamente: adv. perfectly
perfeito	perfeito: adj. perfect
perfil	perfil: n. profile
perfume	perfume: n. perfume
pergunta	pergunta: n. question
perguntar	perguntar: ask
periferia	periferia: n. periphery
perigo	perigo: n. danger
perigosamente	perigosamente: adv. dangerously
perigoso	perigoso: adj. dangerous, perigoso: adj. hazardous
periódico	periódico: adj. periodic
período	período: n. period, período: n. spell
perito	perito: n. expert
permanecer	permanecer: remain
permanência	permanência: n. permanence
permanentemente	permanentemente: adv. permanently
permanente	permanente: adj. permanent
permissão	permissão: n.f. permission, permissão: n.f. permit
permitir	permitir: allow, permitir: permit
perna	perna: n. leg
perpétuo	perpétuo: adj. perpetual
perseguição	perseguição: n. chase, perseguição: n. persecution, perseguição: n. pursuit
perseguir	perseguir: pursue
persistir	persistir: persist
personagem	personagem: n.f. character
personalidade	personalidade: n. personality
perspectiva	perspectiva: n. perspective, perspectiva: n. prospect
pertence	pertence: n.m. belonging
pertencer	pertencer: belong
perto	perto: adv. near, perto: adv. near here
perturbar	perturbar: perturb
peruano	peruano: adj. Peruvian
perverso	perverso: adj. perverse
pesadelo	pesadelo: n.m. nightmare
pesar	pesar: weigh
pescar	pescar: fish
pescoço	pescoço: n. neck
peseta	peseta: n. peseta
peso	peso: n. weight
pesquisador	pesquisador: n. researcher
pesquisa	pesquisa: n. investigation, pesquisa: n. research
pesquisar	pesquisar: investigate, pesquisar: research
pessoalmente	pessoalmente: adv. personally
pessoal	pessoal: n. personnel, pessoal: n. staff, pessoal: n. staff, pessoal: adj. personal
pessoa	pessoa: n. person
petição	petição: n. request
petróleo	petróleo: n. oil
piano	piano: n. piano
picar	picar: hammer
piedade	piedade: n. mercy
pilotar	pilotar: pilot
piloto	piloto: n. pilot
pintar	pintar: colour, pintar: paint
pintor	pintor: n. painter
pintura	pintura: n. paint, pintura: n. painting
piorar	piorar: worsen
pior	pior: adj. bad, pior: adj. bad
pista	pista: n. hint, pista: n. track
pistola	pistola: n. gun
placa	placa: n. plate
placar	placar: n. result
planeamento	planeamento: n.m. planning
planear	planear: plan
planejamento	planejamento: n. planing, planejamento: n.m. planning
planeta	planeta: n. planet
planície	planície: n. plain
planificar	planificar: schedule
plano	plano: n. plan, plano: n. plane, plano: adj. flat
planta	planta: n. plant
plantar	plantar: plant
plástico	plástico: n. plastic
plataforma	plataforma: n. platform
plenamente	plenamente: adv. fully
pleno	pleno: adj. full
pluma	pluma: n. feather
plural	plural: n. plural, plural: adj. plural
pneumático	pneumático: adj. pneumatic
pneumonia	pneumonia: n. pneumonia
pneu	pneu: n. tire, pneu: n. tyre
pobre	pobre: adj.mf. poor
pobreza	pobreza: n. poverty
poderosamente	poderosamente: adv. powerfully
poderoso	poderoso: adj. powerful
poder	poder: n. power
poema	poema: n. poem
poente	poente: n.m. speaker
poesia	poesia: n. poetry
poeta	poeta: n.m. poet, poeta: n.f. poet, poeta: n.GD. poet
poético	poético: adj. poetic
polémica	polémica: n. controversy
polêmica	polêmica: n. controversy
policial	policial: n. police, policial: n. policeman, policial: adj. police
polícia	polícia: n. police, polícia: n. policeman, polícia: n. policewoman
policiar	policiar: watch
politicamente	politicamente: adv. politically
político	político: n. politician, político: adj. political
pólo	pólo: n. pole
pombo	pombo: n. pigeon
ponderar	ponderar: appraise, ponderar: value
ponta	ponta: n.f. tip
ponte	ponte: n.f. bridge
ponto	ponto: n. dot, ponto: n. point
pontualmente	pontualmente: adv. on time
pontual	pontual: adj. prompt, pontual: adj. punctual
pó	pó: n.m.sg. dust, pó: n.m.sg. dust, pó: n.m.sg. pulse
pop	pop: n. octopus, pop: n. octopus, pop: n. pop
população	população: n. population
popularidade	popularidade: n. popularity
popularmente	popularmente: adv. commonly
popular	popular: adj. popular
por acaso	por acaso: adv. by chance
por atacado	por atacado: adv. in bulk, por atacado: adv. wholesale
por causa de	por causa de: pr. because of
por certo	por certo: adv. surely
porco	porco: n.m. pig, porco: n.m. pork, porco: n.f. sow
por enquanto	por enquanto: adv. for the meantime, por enquanto: adv. for the moment
por entre	por entre: pr. among, por entre: pr. between
pormenorizar	pormenorizar: detail
por	por: pr. by, por: pr. for, por: pr. per
pôr	pôr: lay, pôr: put, pôr: set
por que	por que: adv. why
porque	porque: cnjadv. because, porque: cnjadv. so that
portal	portal: n. portal
portanto	portanto: cnjadv. therefore
portar	portar: bring, portar: carry
porta-voz	porta-voz: n. spokesman, porta-voz: n. spokeswoman
por todos os lados	por todos os lados: adv. all over
porto	porto: n. harbour, porto: n. port
por trás de	por trás de: pr. behind
português	português: adj. Portuguese
por um fio	por um fio: adv. by a hair's breadth, por um fio: adv. by the skin of her teeth, por um fio: adv. by the skin of his teeth, por um fio: adv. by the skin of its teeth, por um fio: adv. by the skin of my teeth, por um fio: adv. by the skin of one's teeth, por um fio: adv. by the skin of our teeth, por um fio: adv. by the skin of their teeth, por um fio: adv. by the skin of your teeth, por um fio: adv. in the nick of time
por um triz	por um triz: adv. by a hair's breadth
porventura	porventura: adv. possibly
por volta	por volta: adv. around
posar	posar: put
posição	posição: n. position, posição: n. rank, posição: n. stand
positivamente	positivamente: adv. positively
positivo	positivo: adj. positive
posse	posse: n. possession
possibilidade	possibilidade: n. chance, possibilidade: n. possibility
possivelmente	possivelmente: adv. possibly
possível	possível: adj. possible
possuir	possuir: own, possuir: possess
posteriormente	posteriormente: adv. later
posterior	posterior: adj. back, posterior: adj. posterior
posto	posto: n. place
posto que	posto que: cnjadv. although
postura	postura: n. posture
potencialmente	potencialmente: adv. potentially
potente	potente: adj. powerful
pouco depois	pouco depois: adv. shortly afterwards
pouco	pouco: adv. little
poupança	poupança: n.f. saving
poupar	poupar: save, poupar: spare
povoar	povoar: populate
povo	povo: n. village
praça	praça: n. square
prado	prado: n. meadow
praia	praia: n. beach
pra	pra: pr. for
prata	prata: n. silver
praticamente	praticamente: adv. practically
praticante	praticante: n. practitioner
prática	prática: n. practice
praticar	praticar: practice, praticar: practise
prático	prático: adj. practical
prazer	prazer: n. pleasure
prazo	prazo: n. term
precário	precário: adj. precarious
precedente	precedente: n. precedent, precedente: adj. previous
preceder	preceder: precede
precioso	precioso: adj. lovely, precioso: adj. precious
precipitação	precipitação: n. precipitation
precipitar	precipitar: precipitate
precisamente	precisamente: adv. precisely
precisão	precisão: n. accuracy
precisar	precisar: need
preciso	preciso: adj. precise
preconceito	preconceito: n. prejudice
preço	preço: n. price
predição	predição: n. prediction
prédio	prédio: n. building
preencher	preencher: fill
prefeito	prefeito: n. mayor
prefeitura	prefeitura: n.f. city council, prefeitura: n.f. town council, prefeitura: n.f. town hall
preferência	preferência: n. preference
preferir	preferir: prefer
preferível	preferível: adj. preferable
pregar	pregar: preach
prejudicar	prejudicar: prejudice
preliminar	preliminar: adj. preliminary
premiar	premiar: reward
prémio	prémio: n. award, prémio: n. prize
prender	prender: arrest
preocupação	preocupação: n. concern, preocupação: n. worry
preocupante	preocupante: adj. worrisome
preocupar	preocupar: concern, preocupar: worry
preparação	preparação: n. preparation
preparar	preparar: prepare
pré-requisito	pré-requisito: n. requirement
prescrever	prescrever: prescribe
presença	presença: n. presence
presentear	presentear: give
presente	presente: n. gift, presente: n. present, presente: adj. present
preservar	preservar: preserve
presidencial	presidencial: adj. presidential
presidência	presidência: n. chair, presidência: n. presidency
presidente	presidente: n. chairman, presidente: n. chairperson, presidente: n. president
presidir	presidir: chair
preso	preso: n. prisoner
pressão	pressão: n. pressure, pressão: n. strain
prestação	prestação: n. benefit, prestação: n. feature, prestação: n. provision
prestar	prestar: loan
prestígio	prestígio: n. prestige
presunção	presunção: n. presumption
presunto	presunto: n. ham
pretender	pretender: intend, pretender: pretend
pretensamente	pretensamente: adv. purportedly
pretensão	pretensão: n. pretence
pretexto	pretexto: n. pretext
preto	preto: adj.m.sg. black, preto: adj.f.sg. black, preto: adj.m.pl. black, preto: adj.f.pl. black, preto: adj. black
prevalecer	prevalecer: prevail
prevenção	prevenção: n.f. prevention
preventivo	preventivo: adj. preventive
prever	prever: foresee
previamente	previamente: adv. previously
prévio	prévio: adj. previous, prévio: adj. prior
previsão	previsão: n. forecast
previsível	previsível: adj. predictable
primar	primar: prevail
primavera	primavera: n. spring
primeiramente	primeiramente: adv. firstly
primeiro	primeiro: adv. first
primitivo	primitivo: adj. primitive
primordial	primordial: adj. overriding
principalmente	principalmente: adv. chiefly, principalmente: adv. mainly, principalmente: adv. primarily, principalmente: adv. principally
principal	principal: adj. main, principal: adj. principal
príncipe	príncipe: n. prince, príncipe: n. princess
princípio	princípio: n. principle
prioridade	prioridade: n. priority
prisão	prisão: n. jail, prisão: n. prison
prisioneiro	prisioneiro: n. prisoner, prisioneiro: n. setscrew
privado	privado: adj. private
privar	privar: deprive
privatização	privatização: n. privatization
privatizar	privatizar: denationalize
privilégio	privilégio: n. privilege
probabilidade	probabilidade: n. probability
problema	problema: n. problem, problema: n. trouble
proceder	proceder: proceed
procedimento	procedimento: n. procedure
processo	processo: n. process
procissão	procissão: n. procession
proclamar	proclamar: proclaim
procriação	procriação: n. procreation
procurar	procurar: look for, procurar: search, procurar: search for, procurar: seek
prodígio	prodígio: n. prodigy
produção	produção: n. output, produção: n. production
produto	produto: n. produce, produto: n. product
produtor	produtor: n. producer
produzir	produzir: produce
professor	professor: n. professor
profeta	profeta: n. prophet
profissão	profissão: n. profession
profissionalmente	profissionalmente: adv. professionally
profissional	profissional: n. professional, profissional: adj. professional
profundamente	profundamente: adv. acutely, profundamente: adv. deeply, profundamente: adv. profoundly
profundeza	profundeza: n. depth
profundidade	profundidade: n. depth
profundo	profundo: adj. deep, profundo: adj. profound
prognóstico	prognóstico: n. prognosis
programação	programação: n. programming
programa	programa: n. program, programa: n. programme, programa: n. schedule
progredir	progredir: progress
progressão	progressão: n. progression
progressivamente	progressivamente: adv. progressively
progressivo	progressivo: adj. progressive
progresso	progresso: n. advance, progresso: n. advancement, progresso: n. progress
proibição	proibição: n. ban, proibição: n. prohibition
proibir	proibir: ban, proibir: forbid
projeção	projeção: n. projection
projecção	projecção: n. projection
projectar	projectar: project
projecto	projecto: n. project
projetar	projetar: project
projeto	projeto: n. project
promessa	promessa: n. promise
prometer	prometer: promise
promoção	promoção: n. promotion
promotor	promotor: n. promoter
promover	promover: promote
pronto	pronto: adj. clever, pronto: adj. smart, pronto: adv. soon
pronunciar	pronunciar: pronounce
propaganda	propaganda: n. propaganda
propagar	propagar: propagate
propício	propício: adj. favourable
proporção	proporção: n. proportion, proporção: n. ratio
proporcionar	proporcionar: afford, proporcionar: provide
propor	propor: pose, propor: propose, propor: state
proposição	proposição: n. proposition
propósito	propósito: n. purpose
proposta	proposta: n. proposal
propriedade	propriedade: n. estate, propriedade: n. ownership, propriedade: n. property
proprietário	proprietário: n. owner
próprio	próprio: adj. own, próprio: adj. proper
prorrogação	prorrogação: n. extra time
prosperidade	prosperidade: n. prosperity
prostituição	prostituição: n. prostitution
prostituta	prostituta: n. prostitute
protagonista	protagonista: n. protagonist
proteção	proteção: n. protection
protecção	protecção: n. protection
protector	protector: adj. protective
proteger	proteger: protect
proteína	proteína: n. protein
protestante	protestante: n. Protestant
protestar	protestar: protest
protesto	protesto: n.m. protest
protetor	protetor: adj. protective
protocolo	protocolo: n. protocol
prova	prova: n. exhibit, prova: n. proof, prova: n. test, prova: n. trial
provar	provar: prove, provar: taste, provar: test, provar: try
provavelmente	provavelmente: adv. likely, provavelmente: adv. presumably, provavelmente: adv. probably
provável	provável: adj. likely, provável: adj. probable, provável: adj. prospective
provedor	provedor: n. provider, provedor: n. supplier
provincial	provincial: adj. provincial
provincia	provincia: n. province
provisão	provisão: n. provision
provisionalmente	provisionalmente: adv. provisionally
provisório	provisório: adj. provisional, provisório: adj.GD. temporary
provocação	provocação: n. provocation
provocar	provocar: cause, provocar: provoke, provocar: trigger
proximidade	proximidade: n. vicinity
próximo	próximo: adj. close, próximo: adj.GD. comer, próximo: adj.GD.ND. comer, próximo: adj. forthcoming, próximo: adj. near, próximo: adj. nearby, próximo: adj. next
prudência	prudência: n. prudence
prudente	prudente: adj. careful
psicologicamente	psicologicamente: adv. psychologically
psicológico	psicológico: adj. psychological
psicólogo	psicólogo: n. psychologist
publicação	publicação: n. publication
publicamente	publicamente: adv. publicly
publicar	publicar: issue, publicar: publish
publicidade	publicidade: n. advert, publicidade: n. advertising, publicidade: n. publicity
público	público: n. public, público: adj. public
pudor	pudor: n. stink
pulmão	pulmão: n. lung
pulsar	pulsar: press, pulsar: push
punhado	punhado: n. bunch
puramente	puramente: adv. purely
puro	puro: adj. pure
puxar	puxar: pull
quadra	quadra: n. apple
quadro	quadro: n. picture
qualidade	qualidade: n. quality
qualificação	qualificação: n. qualification
qualificar	qualificar: zone
qual	qual: prn.itg.mf. which, qual: prn.itg.mf. which one
qualquer	qualquer: det. any, qualquer: det. either, qualquer: det. whatever, qualquer: prn. any, qualquer: prn. any one, qualquer: prn. anybody, qualquer: prn. anyone, qualquer: prn. either
quando	quando: adv. when
quantidade	quantidade: n. amount, quantidade: n. quantity
quanto a	quanto a: pr. regarding
quanto	quanto: prn. how many, quanto: prn. how much
quarta-feira	quarta-feira: n.f.ND. Wednesday, quarta-feira: n.f.sg. Wednesday, quarta-feira: n.f.pl. Wednesday
quartel	quartel: n.m. barracks
quatorze	quatorze: num. fourteen
quebra	quebra: n. failure
quebrar	quebrar: break
queda	queda: n. fall
queijo	queijo: n. cheese
queimadura	queimadura: n. burn
queimar	queimar: burn
quem	quem: prn.itg.mf.sp. who, quem: rel.nn.mf.sp. the one who, quem: rel.nn.mf.sp. those who, quem: rel.nn.mf.sp. who, quem: rel.nn.mf.sp. whom
quem quer	quem quer: prn.tn.mf.sp. any one, quem quer: prn.tn.mf.sp. anyone
quente	quente: adj.mf. hot
que	que: cnjsub. that, que: prn.itg. what, que: rel. that, que: rel. which, que: rel. who
querer	querer: vbmod. want to, querer: want
questão	questão: n. question
qüestão	qüestão: n. question
questionar	questionar: question
quiçá	quiçá: adv. maybe, quiçá: adv. perhaps
quilômetro	quilômetro: n. kilometer
quilómetro	quilómetro: n. kilometer, quilómetro: n. kilometre
químico	químico: n. chemist, químico: adj. chemical
quinta-feira	quinta-feira: n.f.ND. Thursday, quinta-feira: n.f.sg. Thursday, quinta-feira: n.f.pl. Thursday
quintal	quintal: n. playground, quintal: n. yard
quinze	quinze: num. fifteen
quotidiano	quotidiano: adj. daily
racial	racial: adj. racial
racismo	racismo: n. racism
racista	racista: adj. racist
radar	radar: n. radar
radicalmente	radicalmente: adv. radically
radical	radical: adj. radical
rádio	rádio: n.f. radio, rádio: n.m. radio
rainha	rainha: n.f. king, rainha: n.f. queen
raio	raio: n. ray
raiva	raiva: n. anger, raiva: n. rabies, raiva: n. rage
raiz	raiz: n. root, raiz: n. stem
ramo	ramo: n.m. bouquet, ramo: n.m. branch, ramo: n.m. bunch
rapariga	rapariga: n.f. boy, rapariga: n.f. girl
rapaz	rapaz: n.m. boy, rapaz: n.m. girl
rapidamente	rapidamente: adv. at the double, rapidamente: adv. full blast, rapidamente: adv. hand over fist, rapidamente: adv. on the doble, rapidamente: adv. quick, rapidamente: adv. quickly, rapidamente: adv. rapidly, rapidamente: adv. swiftly
rapidez	rapidez: n. rapidity
rápido	rápido: adj. fast, rápido: adj. quick, rápido: adj. rapid
raro	raro: adj. rare
rasgo	rasgo: n. shot
rato	rato: n. mouse
razão	razão: n. reason
razoavelmente	razoavelmente: adv. reasonably, razoavelmente: adv. within reason
razoável	razoável: adj. reasonable
reação	reação: n. reaction
reacção	reacção: n. reaction
reagir	reagir: react
realidade	realidade: n. reality
realismo	realismo: n. realism
realista	realista: adj. realistic
realização	realização: n. realization
realizar	realizar: realise, realizar: realize
realmente	realmente: adv. really
real	real: adj. actual, real: adj. real, real: adj. royal
rebaixamento	rebaixamento: n. descent
rebanho	rebanho: n. herd
rebelde	rebelde: n. rebel, rebelde: adj. rebellious
receber	receber: get, receber: receive
recender	recender: smell
recentemente	recentemente: adv. freshly, recentemente: adv. recently
recente	recente: adj. recent
recepção	recepção: n. receipt, recepção: n. reception
receptor	receptor: n. receptor
recessão	recessão: n. recession, recessão: n. slump
rechaçar	rechaçar: refuse
reclamação	reclamação: n. claim
reclamar	reclamar: claim, reclamar: demand
reclusão	reclusão: n. seclusion
recolher	recolher: collect, recolher: pick
recomendação	recomendação: n. recommendation
recomendar	recomendar: recommend
reconhecer	reconhecer: acknowledge, reconhecer: recognize
reconhecimento	reconhecimento: n. recognition
reconstrução	reconstrução: n. reconstruction
recordar	recordar: remember, recordar: remind
recorde	recorde: n. record
récord	récord: n. record
recorrer	recorrer: resort
recto	recto: adj. straight
recuar	recuar: back
recuperação	recuperação: n. recovery
recuperar	recuperar: recover, recuperar: recuperate, recuperar: retrieve
recurso	recurso: n. resort, recurso: n. resource
recusar	recusar: dismiss, recusar: refuse
redação	redação: n. editorial staff, redação: n. writing
redacção	redacção: n. editorial staff, redacção: n. writing
redemoinho	redemoinho: n. eddy
rede	rede: n. net, rede: n. network
redigir	redigir: draft
redondo	redondo: adj. round
redução	redução: n. reduction
reduzir	reduzir: reduce
reeleição	reeleição: n. reelection
reestruturação	reestruturação: n. restructuring
refém	refém: n. hostage
referência	referência: n. reference
referendo	referendo: n. referendum, referendo: n. referendum
referendum	referendum: n. referendum
referente	referente: n. referent
referir	referir: refer
refletir	refletir: reflect
reflexão	reflexão: n. reflection
reforma	reforma: n. reform
reformar	reformar: reform
refúgio	refúgio: n. shelter
regenerar	regenerar: regenerate
região	região: n. region
regime	regime: n. diet
regional	regional: adj. regional
registar	registar: register, registar: scour
registo	registo: n. register
registrar	registrar: register
registro	registro: n. record, registro: n. recording, registro: n. register, registro: n. register
regra	regra: n. rule
regressar	regressar: give back, regressar: go back
regresso	regresso: n. return
regulamentar	regulamentar: adj.mf. statutory
regulamento	regulamento: n.m. rule
regularmente	regularmente: adv. regularly
regular	regular: adj. regular, regular: adj.mf. standard, regular: regulate
reino	reino: n. kingdom
rei	rei: n.m. king, rei: n.m. queen
reiterar	reiterar: reiterate
reitor	reitor: n. rector
rejeitar	rejeitar: refuse
relação	relação: n. account, relação: n. relation, relação: n. relationship
relacionar	relacionar: relate
relativamente	relativamente: adv. relatively
relativo	relativo: adj. relative
relatório	relatório: n. report
relevo	relevo: n. relief
religião	religião: n. religion
religioso	religioso: adj. religious
relógio	relógio: n. clock, relógio: n. watch
reluzente	reluzente: adj.mf. shiny
remarcar	remarcar: remark
remédio	remédio: n. remedy
remeter	remeter: remit
reminiscência	reminiscência: n. reminiscence
remontar	remontar: trace back
remoto	remoto: adj. remote
remover	remover: stir up
rendimento	rendimento: n. earnings, rendimento: n. income, rendimento: n. performance, rendimento: n. revenue, rendimento: n. revenue
renome	renome: n. nickname
renovação	renovação: n. renewal, renovação: n. renovation
renovar	renovar: renew
renovável	renovável: adj. renewable
reparar	reparar: sense
reparo	reparo: n.m. repair
repartir	repartir: deliver
repentino	repentino: adj. sudden
repercussão	repercussão: n. repercussion
repetição	repetição: n. repetition
repetidamente	repetidamente: adv. repeatedly, repetidamente: adv. time and time again
repetir	repetir: echo, repetir: repeat
replicar	replicar: retort
repórter	repórter: n.mf. reporter
represália	represália: n. reprisal
representação	representação: n. representation
representante	representante: n. representative
representar	representar: figure, representar: represent
representativo	representativo: adj. representative
repressão	repressão: n. repression
reprodução	reprodução: n. reproduction
reproduzir	reproduzir: play, reproduzir: reproduce
republicano	republicano: adj. republican
república	república: n. republic
repugnar	repugnar: revolt
requerer	requerer: require
requisito	requisito: n. requirement
rescisão	rescisão: n. rescission
reserva	reserva: n. reservation, reserva: n. reserve
reservar	reservar: book, reservar: reserve
resfriar	resfriar: cool
resgatar	resgatar: rescue
resgate	resgate: n. rescue
residencial	residencial: adj. residential
residência	residência: n. residence
resistência	resistência: n. resistance
resistente	resistente: adj. resistant
resistir	resistir: resist
resolução	resolução: n. resolution
resolver	resolver: resolve, resolver: settle
respaldar	respaldar: protect
respectivamente	respectivamente: adv. respectively
respectivo	respectivo: adj. respective
respeitar	respeitar: respect
respeito	respeito: n. respect
respiração	respiração: n. breath, respiração: n. breathing
respirar	respirar: breathe
respiratório	respiratório: adj. respiratory
responder	responder: answer, responder: reply
responsabilidade	responsabilidade: n. liability, responsabilidade: n. responsibility
responsável	responsável: n. manager, responsável: adj. responsible
ressentimento	ressentimento: n. resentment
ressoar	ressoar: echo
restabelecer	restabelecer: reinstate
restantes	restantes: det. other
restar	restar: subtract
restauração	restauração: n. restoration
restaurante	restaurante: n. restaurant
restaurar	restaurar: restore
restituição	restituição: n. restitution
resto	resto: n.m. remains, resto: n.m. rest
restrição	restrição: n. restraint, restrição: n. restriction
restringir	restringir: restrict
resultado	resultado: n. outcome, resultado: n. result, resultado: n. score
resultante	resultante: adj. resultant
resultar	resultar: result, resultar: turn out
resvalar	resvalar: slip
reter	reter: retain
retirada	retirada: n. withdrawal
retirar	retirar: withdraw
retomada	retomada: n.f. resumption
retomar	retomar: restart
retoque	retoque: n. retouching
reto	reto: adj. straight
retórica	retórica: n. rhetoric
retórico	retórico: adj. rhetorical
retribuição	retribuição: n. reward
reunião	reunião: n. meeting
reunir	reunir: assemble, reunir: bring together, reunir: gather
revelação	revelação: n. disclosure
revelar	revelar: disclose, revelar: reveal
revisão	revisão: n. review, revisão: n. revision
revisar	revisar: review
revista	revista: n. journal, revista: n. magazine, revista: n. review
revolução	revolução: n. revolution
revolucionário	revolucionário: adj. revolutionary
ribeiro	ribeiro: n. brook
rico	rico: adj. rich, rico: adj. wealthy
ridículo	ridículo: adj. ridiculous
rígido	rígido: adj. rigid
rigoroso	rigoroso: adj. rigorous
rigor	rigor: n. rigour
rio	rio: n. river
riqueza	riqueza: n. wealth
rir	rir: laugh
risco	risco: n. risk
riso	riso: n.m. laugh, riso: n.m. laughter
ritmo	ritmo: n. pace, ritmo: n. rate, ritmo: n. rhythm
rival	rival: n. rival
robô	robô: n. robot
rocha	rocha: n. rock, rocha: n. rock
rock	rock: n. rock
rodada	rodada: n. round
rodear	rodear: surround
rodovia	rodovia: n. road
rogar	rogar: pray
romance	romance: n. novel
romano	romano: adj. roman
romântico	romântico: adj. romantic
romantismo	romantismo: n. romanticism
romper	romper: break, romper: smash
rompimento	rompimento: n.m. break
rosa	rosa: n. pink, rosa: n. rose, rosa: adj. pink
rota	rota: n. route
rotativo	rotativo: adj. revolving, rotativo: adj. rotary
roteiro	roteiro: n. script
rotundamente	rotundamente: adv. categorically, rotundamente: adv. roundly
roubar	roubar: steal
roubo	roubo: n. theft
roupa	roupa: n. cloth, roupa: n. clothes, roupa: n. clothing
rouxinol	rouxinol: n. nightingale
rua	rua: n.f. street
rugir	rugir: roar
ruído	ruído: n. noise
ruína	ruína: n. ruin
rumor	rumor: n.m. rumble
ruptura	ruptura: n. breach, ruptura: n. split
rural	rural: adj. rural
russo	russo: n. Russian, russo: adj. Russian
sábado	sábado: n. Saturday
saber	saber: n. learning, saber: know
sábio	sábio: adj. wise
sabor	sabor: n. flavor, sabor: n. flavour
sacar	sacar: pull out, sacar: remove, sacar: take away, sacar: take off, sacar: take out
sacerdote	sacerdote: n. priest
saciedade	saciedade: n. satiety
saco	saco: n. sack
sacrificar	sacrificar: sacrifice
sacrifício	sacrifício: n. sacrifice
sacudir	sacudir: shake
safra	safra: n. harvest
sagrado	sagrado: adj. holy, sagrado: adj. sacred
saia	saia: n. skirt
saída	saída: n. departure, saída: n. exit, saída: n. output, saída: n. start
sair	sair: come out, sair: exit, sair: go out, sair: work out
salário	salário: n. salary, salário: n. wage
sala	sala: n. hall, sala: n. room
saldo	saldo: n. balance
salientar	salientar: highlight
saltar	saltar: jump, saltar: leap, saltar: spring
salto	salto: n. jump, salto: n. leap
salvação	salvação: n. salvation
salvar	salvar: save
sanção	sanção: n. punishment
sangue	sangue: n.m. blood
sanitário	sanitário: adj. sanitary
santo	santo: n. saint
santuário	santuário: n. sanctuary
são	são: adj. healthy
satélite	satélite: n. satellite
satisfação	satisfação: n. satisfaction
satisfatório	satisfatório: adj. satisfactory
satisfazer	satisfazer: satisfy
saudar	saudar: greet
saúde	saúde: n. health
se bem que	se bem que: cnjadv. although
seção	seção: n. section
secar	secar: dry
seca	seca: n. drought
secção	secção: n. section
seco	seco: adj. dry
secretariado	secretariado: n. secretariat
secretário	secretário: n. secretary
sector	sector: n. sector
século	século: n. century
secundário	secundário: adj. secondary
sediar	sediar: receive
sedução	sedução: n. seduction
seduzir	seduzir: seduce
segredo	segredo: n. secret
seguidor	seguidor: n. fan, seguidor: n. following, seguidor: n. supporter
seguinte	seguinte: adj. following
seguir	seguir: follow, seguir: keep
segunda-feira	segunda-feira: n.f.ND. Monday, segunda-feira: n.f.sg. Monday, segunda-feira: n.f.pl. Monday
segundo	segundo: n. second, segundo: cnjadv. as, segundo: pr. according, segundo: pr. according to
seguramente	seguramente: adv. surely
segurança	segurança: n.f. safety, segurança: n.f. security, segurança: n.mf. watchdog
segurar	segurar: take
seguro	seguro: adj. certain, seguro: adj. confident, seguro: adj. safe, seguro: adj. secure, seguro: adj. sure, seguro: adv. sure
seita	seita: n. sect
seleção	seleção: n. selection
selecção	selecção: n. selection
seleccionar	seleccionar: select
selecionar	selecionar: select
selectivo	selectivo: adj. selective
seletivo	seletivo: adj. selective
selo	selo: n. seal, selo: n. stamp
selvagem	selvagem: adj. wild
selva	selva: n. jungle
semanalmente	semanalmente: adv. weekly
semanal	semanal: adj. weekly
semana	semana: n. week
semelhante	semelhante: adj. akin, semelhante: adj. alike
semente	semente: n. seed
semestre	semestre: n. semester
seminário	seminário: n. seminar
sempre	sempre: adv. always
sem	sem: pr. without
senador	senador: n. senator
senão	senão: cnjcoo. but, senão: cnjcoo. but rather
senha	senha: n.f. signal
senhor	senhor: n. gentleman, senhor: n. lady, senhor: n. lord, senhor: n. sir
sensação	sensação: n. feeling
sensatez	sensatez: n.f. wisdom
sensato	sensato: adj. wise
sensibilidade	sensibilidade: n. sensitivity
sensivelmente	sensivelmente: adv. noticeably
sensível	sensível: adj. sensitive
sentar	sentar: seat, sentar: sit, sentar: sit down
sentença	sentença: n. judgement, sentença: n. judgment, sentença: n. sentence
sentenciar	sentenciar: sentence
sentido	sentido: n. direction, sentido: n. sense
sentimental	sentimental: adj. sentimental
sentimento	sentimento: n. feeling
sentir	sentir: feel, sentir: hear
separação	separação: n. separation
separar	separar: part, separar: separate
sequência	sequência: n. sequence
seqüência	seqüência: n. sequence
sequer	sequer: adv. at least
sequestrar	sequestrar: kidnap
seqüestrar	seqüestrar: kidnap
seriamente	seriamente: adv. in earnest, seriamente: adv. seriously, seriamente: adv. seriously now, seriamente: adv. to be serious
seriedade	seriedade: n. seriousness
série	série: n. series
sério	sério: adj. serious
serpente	serpente: n. snake
ser	ser: n. being, ser: vbser. be
serviço	serviço: n. service
servidão	servidão: n. servitude
servidor	servidor: n. server
sérvio	sérvio: n. Serbian
servir	servir: serve
se	se: cnjadv. if, se: cnjadv. provided, se: cnjadv. whether
sessão	sessão: n. session
seta	seta: n. arrow
setembro	setembro: n. September
setor	setor: n. sector
seu	seu: det.pos. his, seu: adj. hers, seu: adj. his, seu: adj. theirs
severo	severo: adj. severe
sexo	sexo: n. sex
sexta-feira	sexta-feira: n.f.ND. Friday, sexta-feira: n.f.sg. Friday, sexta-feira: n.f.pl. Friday
sexualmente	sexualmente: adv. sexually
sexual	sexual: adj. sexual
significação	significação: n. significance
significar	significar: mean
significativo	significativo: adj. meaningful, significativo: adj. significant
signo	signo: n. sign
silêncio	silêncio: n. silence
silencioso	silencioso: adj. silent
simbólico	simbólico: adj. symbolic
simbolismo	simbolismo: n. symbolism
simbolizar	simbolizar: symbolize
símbolo	símbolo: n. symbol
similar	similar: adj. similar
simplesmente	simplesmente: adv. simply
simples	simples: adj.mf.sp. facile, simples: adj.mf.sp. simple
sim	sim: adv. yes
simular	simular: simulate
simultaneamente	simultaneamente: adv. simultaneously
simultâneo	simultâneo: adj. simultaneous
sinal	sinal: n.m. sign, sinal: n.m. signal
sinceramente	sinceramente: adv. earnestly, sinceramente: adv. genuinely, sinceramente: adv. in all conscience, sinceramente: adv. in fairness, sinceramente: adv. sincerely
sinceridade	sinceridade: n. sincerity
sindical	sindical: adj. sindical
sindicato	sindicato: n. union
síndroma	síndroma: n.f. syndrome
síndrome	síndrome: n.f. syndrome
singelamente	singelamente: adv. simply
singelo	singelo: adj. plain, singelo: adj. simple
singular	singular: adj. singular
sino	sino: n.m. bell
síntese	síntese: n.f. synthesis
sintoma	sintoma: n. symptom
sistema	sistema: n. system
sistematicamente	sistematicamente: adv. systematically
sistemático	sistemático: adj. systematic
sistémico	sistémico: adj. systematic
site	site: n.m. web
situação	situação: n. situation
situar	situar: situate
soar	soar: sound
soberania	soberania: n. sovereignty
soberano	soberano: n. sovereign
sob medida	sob medida: adv. to size
sobrancelha	sobrancelha: n. eyebrow
sobre	sobre: pr. about, sobre: pr. on, sobre: pr. on top of, sobre: pr. over
sobretudo	sobretudo: adv. above all, sobretudo: adv. especially
sobrevivência	sobrevivência: n. survival
sobreviver	sobreviver: survive
sobrinho	sobrinho: n. nephew, sobrinho: n. niece
sob	sob: pr. under
socialista	socialista: n. socialist, socialista: adj. socialist
socialmente	socialmente: adv. socially
social	social: adj. social
sociedade	sociedade: n. partnership, sociedade: n. society
sócio	sócio: n. partner
sofrimento	sofrimento: n. suffering
soja	soja: n. soybean
soldado	soldado: n. soldier
solene	solene: adj. solemn
solicitação	solicitação: n. appeal, solicitação: n. application
solicitante	solicitante: n. applicant
solicitar	solicitar: apply for, solicitar: request, solicitar: solicit
solicitude	solicitude: n. application
solidão	solidão: n. solitude
solidariedade	solidariedade: n. solidarity
sólido	sólido: adj. solid
solitário	solitário: adj. lonely, solitário: adj. solitary
solo	solo: n. soil
sol	sol: n. sun
solução	solução: n. solution
solucionar	solucionar: solve
somar	somar: add
soma	soma: n.f. sum
sombra	sombra: n. shade, sombra: n. shadow
sombrio	sombrio: adj. shady
somente	somente: adv. only
som	som: n. sound
sonda	sonda: n. catheter, sonda: n. probe
sonhar	sonhar: dream
sonho	sonho: n. dream
sonoro	sonoro: adj. audible
soprar	soprar: blow
sorrir	sorrir: smile
sorriso	sorriso: n.m. smile
sorteio	sorteio: n. draw
sorte	sorte: n. luck
só	só: adv. just, só: adv. only, só: adv. solely
sotaque	sotaque: n. accent
soterrar	soterrar: bury
soviético	soviético: adj. Soviet
sozinho	sozinho: adj. alone, sozinho: adj. only, sozinho: adj. single
standard	standard: n. standard
suave	suave: adj. gentle, suave: adj. mild, suave: adj. soft
suavidade	suavidade: n. softness
suavizar	suavizar: soften
subida	subida: n. rise, subida: n. slope
subir	subir: go up
súbito	súbito: adj. sudden
sublime	sublime: adj. sublime
sublinhar	sublinhar: underline
submeter	submeter: subject, submeter: submit
substância	substância: n. substance
substituir	substituir: replace, substituir: substitute
subtítulo	subtítulo: n. subhead
sucessivo	sucessivo: adj. successive
sucessor	sucessor: n. successor
sucesso	sucesso: n. hit, sucesso: n. success
suco	suco: n. juice
sucursal	sucursal: n. branch
sudoeste	sudoeste: n. southwest
sueco	sueco: adj. Swedish
suficientemente	suficientemente: adv. sufficiently
suficiente	suficiente: adj. sufficient
sugerir	sugerir: suggest
sugestão	sugestão: n.f. suggestion
suicídio	suicídio: n. suicide
suíço	suíço: n. Swiss, suíço: adj. Swiss
sujeira	sujeira: n. dirt
sujeitar	sujeitar: attach
sujeito	sujeito: n. subject, sujeito: adj. subject
sujo	sujo: adj. dirty, sujo: adj. gross
sul	sul: n. south
sumário	sumário: n. summary
suor	suor: n.m. sweat, suor: n.m. sweat, suor: n.m. sweat
superar	superar: exceed, superar: surpass
superficial	superficial: adj. shallow, superficial: adj. superficial
superior	superior: adj. superior, superior: adj. top, superior: adj. upper
supermercado	supermercado: n. supermarket
suplemento	suplemento: n. supplement
supor	supor: assume, supor: suppose
suposição	suposição: n. assumption, suposição: n. guess
supostamente	supostamente: adv. allegedly, supostamente: adv. purportedly, supostamente: adv. supposedly
suposto	suposto: adj. presumptive
supremo	supremo: adj. supreme
suprimir	suprimir: suppress
surdo	surdo: adj. deaf
surgir	surgir: arise, surgir: emerge
surpreendentemente	surpreendentemente: adv. surprisingly
surpreendente	surpreendente: adj. surprising
surpreender	surpreender: surprise
surpresa	surpresa: n.f. surprise
surra	surra: n. licking
susceptível	susceptível: adj. susceptible
suspeitar	suspeitar: suspect
suspeita	suspeita: n. suspicion
suspeito	suspeito: adj. suspicious
suspender	suspender: suspend
suspensão	suspensão: n. suspension
suspirar	suspirar: sigh
suspiro	suspiro: n. sigh
sustentadamente	sustentadamente: adv. continuously
sustentar	sustentar: sustain
tabaco	tabaco: n. tobacco
tabela	tabela: n. table, tabela: n. table
tabuleiro	tabuleiro: n. board, tabuleiro: n. panel
tabu	tabu: n. taboo
táctica	táctica: n. tactics
táctico	táctico: adj. tactical
tailandês	tailandês: adj. Thai
talento	talento: n. talent, talento: n. wit
talhar	talhar: cut
também não	também não: adv. either, também não: adv. neither
também	também: adv. also, também: adv. as well, também: adv. too
tambor	tambor: n. drum
tampa	tampa: n.f. cap, tampa: n. lid, tampa: n.f. plug
tampouco	tampouco: adv. neither
tanque	tanque: n. tank
tanto	tanto: adv. so much
tão	tão: preadv. as, tão: preadv. just as, tão: preadv. so
tapete	tapete: n.m. carpet
tarde	tarde: n. afternoon, tarde: adv. late
tarefa	tarefa: n. task, tarefa: n. undertaking
tarifa	tarifa: n. price, tarifa: n. rate
tática	tática: n. tactics
tático	tático: adj. tactical
táxi	táxi: n. taxi
teatral	teatral: adj. theatrical
teatro	teatro: n. drama, teatro: n. theater, teatro: n. theatre
tecer	tecer: knit
tecido	tecido: n. fabric, tecido: n. tissue
tecla	tecla: n. key
tecnicamente	tecnicamente: adv. technically
técnico	técnico: n. technician, técnico: adj. technical
tecnológico	tecnológico: adj. technological
teia de aranha	teia de aranha: n. cobweb, teia de aranha: n. web
tela	tela: n. canvas, tela: n. cloth, tela: n. display, tela: n. screen
telecomunicação	telecomunicação: n. telecommunication
telefone	telefone: n. phone, telefone: n. telephone
telefónico	telefónico: adj. telephonic
telefônico	telefônico: adj. telephonic
telescópio	telescópio: n. telescope
televisão	televisão: n. television
tema	tema: n. subject, tema: n. theme, tema: n. topic
temático	temático: adj. thematic
temer	temer: fear
temível	temível: adj. fearsome
temperatura	temperatura: n. temperature
templo	templo: n. temple
temporada	temporada: n. season
temporão	temporão: adj. early
temporariamente	temporariamente: adv. temporarily
tempo	tempo: n.m.ND. time, tempo: n.m.pl. time, tempo: n.m.sg. time, tempo: n.m.ND. weather, tempo: n.m.pl. weather, tempo: n.m.sg. weather
tencionar	tencionar: project
tendência	tendência: n. tendency, tendência: n. trend
tender	tender: tend
tenista	tenista: n. tennist
tênis	tênis: n. tennis, tênis: n. tennis
tenro	tenro: adj. tender
tensão	tensão: n. strain, tensão: n. stress, tensão: n. tension
tenso	tenso: adj.f. taut, tenso: adj.GD. taut, tenso: adj.m. taut
tentar	tentar: attempt, tentar: tempt, tentar: try
tentativa	tentativa: n.f. attempt, tentativa: n.f. bid
teoricamente	teoricamente: adv. theoretically
terapêutico	terapêutico: adj. remedial, terapêutico: adj. therapeutic
terapia	terapia: n. therapy
terça-feira	terça-feira: n.f.ND. Tuesday, terça-feira: n.f.sg. Tuesday, terça-feira: n.f.pl. Tuesday
terço	terço: n. third
ter de	ter de: vbmod. have to
térmico	térmico: adj. thermal
terminal	terminal: n.m. terminal, terminal: adj. terminal
terminar	terminar: finish
término	término: n. term
termo	termo: n. term
terno	terno: adj. tender
ter que	ter que: vbmod. have to
terramoto	terramoto: n. earthquake
terra	terra: n. earth, terra: n. floor, terra: n. ground, terra: n. land, terra: n. soil
terremoto	terremoto: n. earthquake
terreno	terreno: n. terrain
terrestre	terrestre: adj. terrestrial
territorial	territorial: adj. territorial
território	território: n. territory
terrível	terrível: adj. awful, terrível: adj. dreadful, terrível: adj. terrible
terrorismo	terrorismo: n. terrorism
terrorista	terrorista: n. terrorist, terrorista: adj. terrorist
terror	terror: n. terror
ter	ter: vbhaver. have, ter: have, ter: have got, ter: have got
tese	tese: n.f. thesis
tesouro	tesouro: n. treasure
testar	testar: test, testar: try
testemunha	testemunha: n.f. witness
teste	teste: n.m. flowerpot, teste: n.m. pot, teste: n.m. proof, teste: n.m. test
teto	teto: n. ceiling, teto: n. roof
teu	teu: det. your, teu: adj. yours
tevê	tevê: n. television
têxtil	têxtil: adj. textile
texto	texto: n. text
tigre	tigre: n. tiger
tijolo	tijolo: n. brick
timão	timão: n. rudder
time	time: n. team
timidamente	timidamente: adv. shyly
tímido	tímido: adj. shy
tinta	tinta: n. ink
tinzaparina sódica	tinzaparina sódica: n.f. tinzaparin sodium
tinzaparina	tinzaparina: n.f. tinzaparin
tio	tio: n.f. aunt, tio: n.m. uncle
tipicamente	tipicamente: adv. typically
tipo	tipo: n.m. type, tipo: n.m.sg. type
tirano	tirano: n. tyrant
tiro	tiro: n. shot
titular	titular: n.mf. holder, titular: entitle, titular: title
título	título: n. degree, título: n. title
tocar	tocar: play, tocar: touch
todo mundo	todo mundo: prn. everybody, todo mundo: prn. everyone
todo	todo: predet. all, todo: predet. all
tolerar	tolerar: tolerate
tolice	tolice: n. foolishness
tomar	tomar: take
tom	tom: n. key, tom: n. pitch, tom: n. tone
tonelada	tonelada: n. ton, tonelada: n. tonne
tonto	tonto: adj.GD. foolish, tonto: adj. silly
tontura	tontura: n. foolishness
torcer	torcer: curve, torcer: twist
tormenta	tormenta: n. storm
tornar	tornar: do
torneio	torneio: n. tournament
tornozelo	tornozelo: n. ankle
torrencial	torrencial: adj. torrential
torrente	torrente: n.f. torrent
torre	torre: n. tower
torturar	torturar: torture
tortura	tortura: n. torture
tosse	tosse: n.f.pl. cough, tosse: n.f.sg. cough, tosse: n.f.sg. cough, tosse: n.f.pl. cough, tosse: n.f.sg. cough, tosse: n.f.pl. cough, tosse: n.f.sg. cough, tosse: n.f.sg. coughing
totalidade	totalidade: n. whole
totalmente	totalmente: adv. hopelessly, totalmente: adv. totally
total	total: n. total, total: adj. total
tóxico	tóxico: adj. toxic
toxina	toxina: n. toxin
trabalhador	trabalhador: n. worker
trabalhar	trabalhar: work
trabalhista	trabalhista: adj. labour, trabalhista: adj. occupational
trabalho	trabalho: n.m. job, trabalho: n.m. labor, trabalho: n.m. labour, trabalho: n.m. work
tradição	tradição: n. tradition
tradicionalmente	tradicionalmente: adv. traditionally
tradicional	tradicional: adj. traditional
tradução	tradução: n. translation
tradutor	tradutor: n. translator
traduzir	traduzir: translate
tráfego	tráfego: n. traffic
traficante	traficante: n. trafficker
tráfico	tráfico: n. traffic, tráfico: n. trafficking
tragédia	tragédia: n. tragedy
trágico	trágico: adj. tragic
traição	traição: n. betrayal
trajectória	trajectória: n. path
trajetória	trajetória: n. path
traje	traje: n. dress, traje: n. suit
tramitar	tramitar: transact
tranquilizar	tranquilizar: reassure
tranqüilizar	tranqüilizar: reassure
tranquilo	tranquilo: adj. calm
transação	transação: n. transaction
transacção	transacção: n. transaction
transferência	transferência: n. transfer
transformação	transformação: n. transformation
transformar	transformar: transform
transição	transição: n. transition
trânsito	trânsito: n. traffic
transladar	transladar: move
transmissão	transmissão: n. transmission
transmitir	transmitir: convey, transmitir: transmit
transparência	transparência: n. transparency
transparente	transparente: adj. transparent
transplantar	transplantar: transplant
transportar	transportar: convey, transportar: transport
transporte	transporte: n. carriage, transporte: n. transport, transporte: n. transportation
trasladar	trasladar: move
trás	trás: pr. after
tratado	tratado: n. treaty
tratamento	tratamento: n. treatment
tratar	tratar: deal, tratar: deal with, tratar: treat
trato	trato: n. deal
trazer	trazer: bring, trazer: carry, trazer: take, trazer: wear
trégua	trégua: n. truce
treinador	treinador: n. coach, treinador: n. trainer
treinamento	treinamento: n. training
treinar	treinar: train
treino	treino: n. training
tremer	tremer: shiver, tremer: tremble
tremor	tremor: n. tremor
trem	trem: n. train
treze	treze: num. thirteen
tribo	tribo: n. tribe
tribunal	tribunal: n. court
tributo	tributo: n. tribute
trigo	trigo: n. wheat
trimestral	trimestral: adj. quarterly
trimestre	trimestre: n. quarter
tripulação	tripulação: n. crew
tripulante	tripulante: n. crewman
tristemente	tristemente: adv. sadly
triste	triste: adj.mf. sad
triunfo	triunfo: n. triumph
trocar	trocar: exchange
troca	troca: n.f. change, troca: n.f. refill, troca: n.f. spare
troféu	troféu: n. trophy
tronco	tronco: n. trunk
trono	trono: n. throne
tropa	tropa: n. troop
tropical	tropical: adj. tropical
truque	truque: n. trick
t-shirt	t-shirt: n. t-shirt
tudo	tudo: prn. all, tudo: prn. everything
tumba	tumba: n. grave
tumor	tumor: n. tumor
túnel	túnel: n. tunnel
turco	turco: n. Turkish, turco: adj. Turkish
turismo	turismo: n. tourism
turista	turista: n. tourist
turno	turno: n. lathe, turno: n. shift, turno: n. turn
ultimamente	ultimamente: adv. lately
último	último: adj. last, último: adj. latter
umbilical	umbilical: adj. umbilical
umbral	umbral: n. threshold
úmido	úmido: adj. humid
um	um: det. a, um: det. a, um: det. some, um: prn. one
unânime	unânime: adj. unanimous
unanimidade	unanimidade: n. unanimity
unha	unha: n. nail
união	união: n. union
unicamente	unicamente: adv. only
único	único: adj. only, único: adj. unique
unidade	unidade: n. unit, unidade: n. unity
unificar	unificar: unify
unilateralmente	unilateralmente: adv. unilaterally
unilateral	unilateral: adj. unilateral
unir	unir: join, unir: unite
universal	universal: adj. universal
universidade	universidade: n. college, universidade: n. university
universitário	universitário: adj. college, universitário: adj. university
universo	universo: n. universe
urânio	urânio: n. uranium
urbano	urbano: adj. urban
urgência	urgência: n. urgency
urgentemente	urgentemente: adv. urgently
urgente	urgente: adj. urgent
urina	urina: n. urine
urna	urna: n. urn
usar	usar: use
usina	usina: n. factory
uso	uso: n. usage, uso: n. use
usuário	usuário: n. user
utente	utente: n.mf. user
utilidade	utilidade: n. utility
utilização	utilização: n. utilization
utilizar	utilizar: use
útil	útil: adj. helpful, útil: adj. useful
vaca	vaca: n. cow
vacilar	vacilar: hesitate
vacina	vacina: n. vaccine
vaga	vaga: n. vacancy
vaidade	vaidade: n. vanity
valenciano	valenciano: adj. Valencian
valente	valente: adj.mf. brave
valer	valer: be worth, valer: cost
vale	vale: n.m. valley
válido	válido: adj. valid
valioso	valioso: adj. valuable
valoração	valoração: n. assessment
valorizar	valorizar: appraise, valorizar: rate, valorizar: value
valor	valor: n. courage, valor: n. value, valor: n. worth
vantagem	vantagem: n.f. advantage, vantagem: n.f. asset, vantagem: n.f. lead
vão	vão: adj. futile
vapor	vapor: n. steam
varão	varão: n. man
variação	variação: n. variation
variar	variar: vary
vário	vário: det. several, vário: det. several, vário: det. various
varrer	varrer: sweep
vasto	vasto: adj. vast
vau	vau: n. driveway
vazio	vazio: n. gap, vazio: adj. empty, vazio: adj. hollow
veículo	veículo: n. vehicle
vela	vela: n. candle, vela: n. sail
velho	velho: adj. old
velocidade	velocidade: n. speed, velocidade: n. velocity
vencer	vencer: overcome
venda	venda: n. sale
vender	vender: sell
veneno	veneno: n. poison
vento	vento: n. wind
verão	verão: n. summer
verbal	verbal: adj. verbal
verba	verba: n.f. budget, verba: n.f. estimate
verbo	verbo: n. verb
verdadeiramente	verdadeiramente: adv. truly
verdadeiro	verdadeiro: adj. true, verdadeiro: adj.f. true, verdadeiro: adj.m. true
verdade	verdade: n. truth
verde	verde: adj.mf. green, verde: adj.mf. unripe
verdugo	verdugo: n. hangman
vereador	vereador: n. councillor
veredicto	veredicto: n. verdict
vergonha	vergonha: n. embarrassment, vergonha: n. shame
vermelho	vermelho: adj. red
verme	verme: n.m. worm
versão	versão: n. release, versão: n. version
verso	verso: n. verse
vertente	vertente: n.f. slope
verter	verter: dump, verter: pour, verter: tip
verticalmente	verticalmente: adv. vertically
vertical	vertical: adj. vertical
vertigem	vertigem: n. vertigo
ver	ver: see, ver: view
véspera	véspera: n. sunset
vestido	vestido: n. costume, vestido: n. dress, vestido: n. suit
vestir	vestir: dress
veterano	veterano: n. veteran
vez	vez: n. time
viagem	viagem: n.f. journey, viagem: n.f. travel, viagem: n.f. trip
viajante	viajante: n.mf. traveller
viajar	viajar: travel
viatura	viatura: n. vehicle
via	via: n. railway, via: n. road
vice-presidente	vice-presidente: n. vice-president, vice-presidente: n. vice president
vice-versa	vice-versa: adv. vice versa
vício	vício: n. vice
vida	vida: n. life
vídeo	vídeo: n. video
vidro	vidro: n. glass
vigente	vigente: adj. valid
vigiar	vigiar: watch
vigilância	vigilância: n. surveillance
vigilante	vigilante: n. watchdog
vigor	vigor: n. vigour
vínculo	vínculo: n. bond, vínculo: n. tie
vingança	vingança: n. revenge
vingar	vingar: avenge
vinho	vinho: n. wine
violação	violação: n. rape
violência	violência: n. violence
violento	violento: adj. violent
virar	virar: upset
virtualmente	virtualmente: adv. virtually
virtual	virtual: adj. virtual
virtude	virtude: n. virtue
vírus	vírus: n. virus, vírus: n. virus
vir	vir: come
visão	visão: n. vision
visar	visar: pretend
visibilidade	visibilidade: n. visibility
visitante	visitante: n. visitor
visitar	visitar: visit
visita	visita: n. tour, visita: n. visit
visivelmente	visivelmente: adv. visibly
visível	visível: adj. visible
vista	vista: n. hearing, vista: n. sight, vista: n. view
visto	visto: n.m. visa
visual	visual: adj. visual
vital	vital: adj. vital
vítima	vítima: n. victim
vitória	vitória: n. victory
viúvo	viúvo: n. widower
viver	viver: live
vivo	vivo: adj. alive, vivo: adj. lively
vizinho	vizinho: n. neighbour, vizinho: adj. neighbouring
voar	voar: fly
vocação	vocação: n. vocation
vocal	vocal: adj. vocal
vogal	vogal: n. vowel
volante	volante: n. wheel
voltar	voltar: come back, voltar: give back, voltar: go back, voltar: send back
volta	volta: n. turn
volume	volume: n. discharge, volume: n. volume
vontade	vontade: n. will
vôo	vôo: n. flight
voo	voo: n. flight, voo: n. flying
vosso	vosso: det. your, vosso: adj.pos.m.sg. yours, vosso: adj.pos.f.sg. yours, vosso: adj.pos.m.pl. yours, vosso: adj.pos.f.pl. yours
votação	votação: n. vote
votar	votar: vote
voto	voto: n. vote
voz	voz: n. voice
vulcânico	vulcânico: adj. volcanic
vulnerável	vulnerável: adj. vulnerable
web	web: n.f. web
xenofobia	xenofobia: n. xenophobia
xícara	xícara: n. cup
zeloso	zeloso: adj. jealous
zelo	zelo: n. estrus
zona	zona: n. zone
